840,KR,Medium,1960,0-4,2383544,2207268,4590812
840,KR,Medium,1960,10岿 14老,1733443,1617090,3350533
840,KR,Medium,1960,15-19,1358903,1287335,2646238
840,KR,Medium,1960,20-24,1248858,1169586,2418444
840,KR,Medium,1960,25-29,1171363,1151342,2322705
840,KR,Medium,1960,30-34,960543,972537,1933080
840,KR,Medium,1960,35-39,738376,817952,1556328
840,KR,Medium,1960,40-44,682686,687439,1370125
840,KR,Medium,1960,45-49,570525,554509,1125034
840,KR,Medium,1960,05岿 09老,485198,494732,979930
840,KR,Medium,1960,50-54,408634,436622,845256
840,KR,Medium,1960,55-59,289392,339582,628974
840,KR,Medium,1960,60-64,230431,288034,518465
840,KR,Medium,1960,65-69,141661,204014,345675
840,KR,Medium,1960,70-74,80707,129687,210394
840,KR,Medium,1960,75-79,45335,65864,111199
840,KR,Medium,1960,80+,21092,38090,59182
840,KR,Medium,1961,0-4,2452879,2276565,4729444
840,KR,Medium,1961,10岿 14老,1864580,1736162,3600742
840,KR,Medium,1961,15-19,1402613,1332220,2734833
840,KR,Medium,1961,20-24,1240278,1145417,2385695
840,KR,Medium,1961,25-29,1188724,1175745,2364469
840,KR,Medium,1961,30-34,1017695,1010896,2028591
840,KR,Medium,1961,35-39,765035,844596,1609631
840,KR,Medium,1961,40-44,676712,701573,1378285
840,KR,Medium,1961,45-49,584734,568659,1153393
840,KR,Medium,1961,05岿 09老,496049,505185,1001234
840,KR,Medium,1961,50-54,418520,443509,862029
840,KR,Medium,1961,55-59,292521,338083,630604
840,KR,Medium,1961,60-64,239434,296408,535842
840,KR,Medium,1961,65-69,141887,202677,344564
840,KR,Medium,1961,70-74,84914,139524,224438
840,KR,Medium,1961,75-79,47111,69374,116485
840,KR,Medium,1961,80+,22897,42497,65394
840,KR,Medium,1962,0-4,2500793,2323482,4824275
840,KR,Medium,1962,10岿 14老,1983775,1846082,3829857
840,KR,Medium,1962,15-19,1448949,1369542,2818491
840,KR,Medium,1962,20-24,1255899,1150735,2406634
840,KR,Medium,1962,25-29,1204229,1192695,2396924
840,KR,Medium,1962,30-34,1065655,1051348,2117003
840,KR,Medium,1962,35-39,793285,874853,1668138
840,KR,Medium,1962,40-44,679243,713916,1393159
840,KR,Medium,1962,45-49,603816,588586,1192402
840,KR,Medium,1962,05岿 09老,504656,513639,1018295
840,KR,Medium,1962,50-54,432218,454209,886427
840,KR,Medium,1962,55-59,298221,342370,640591
840,KR,Medium,1962,60-64,241992,296126,538118
840,KR,Medium,1962,65-69,148284,212423,360707
840,KR,Medium,1962,70-74,86420,140591,227011
840,KR,Medium,1962,75-79,49893,76638,126531
840,KR,Medium,1962,80+,23655,44812,68467
840,KR,Medium,1963,0-4,2516739,2338441,4855180
840,KR,Medium,1963,10岿 14老,2125558,1975048,4100606
840,KR,Medium,1963,15-19,1492698,1401890,2894588
840,KR,Medium,1963,20-24,1290756,1189724,2480480
840,KR,Medium,1963,25-29,1204791,1187173,2391964
840,KR,Medium,1963,30-34,1107810,1090826,2198636
840,KR,Medium,1963,35-39,836659,900861,1737520
840,KR,Medium,1963,40-44,680161,730953,1411114
840,KR,Medium,1963,45-49,627309,617814,1245123
840,KR,Medium,1963,05岿 09老,510900,517548,1028448
840,KR,Medium,1963,50-54,439228,459774,899002
840,KR,Medium,1963,55-59,316997,360342,677339
840,KR,Medium,1963,60-64,237584,287995,525579
840,KR,Medium,1963,65-69,158662,227507,386169
840,KR,Medium,1963,70-74,85583,137508,223091
840,KR,Medium,1963,75-79,51682,83105,134787
840,KR,Medium,1963,80+,25003,47118,72121
840,KR,Medium,1964,0-4,2487244,2310458,4797702
840,KR,Medium,1964,10岿 14老,2260781,2097314,4358095
840,KR,Medium,1964,15-19,1579817,1480024,3059841
840,KR,Medium,1964,20-24,1309266,1229662,2538928
840,KR,Medium,1964,25-29,1217465,1174094,2391559
840,KR,Medium,1964,30-34,1134420,1114300,2248720
840,KR,Medium,1964,35-39,882373,927427,1809800
840,KR,Medium,1964,40-44,698422,762919,1461341
840,KR,Medium,1964,45-49,642039,643495,1285534
840,KR,Medium,1964,05岿 09老,522679,519811,1042490
840,KR,Medium,1964,50-54,436407,460922,897329
840,KR,Medium,1964,55-59,341962,384049,726011
840,KR,Medium,1964,60-64,237198,284472,521670
840,KR,Medium,1964,65-69,160834,229700,390534
840,KR,Medium,1964,70-74,91624,143992,235616
840,KR,Medium,1964,75-79,53175,90222,143397
840,KR,Medium,1964,80+,26244,49344,75588
840,KR,Medium,1965,0-4,2441718,2269201,4710919
840,KR,Medium,1965,10岿 14老,2360217,2189802,4550019
840,KR,Medium,1965,15-19,1714064,1602738,3316802
840,KR,Medium,1965,20-24,1336648,1271430,2608078
840,KR,Medium,1965,25-29,1224348,1151445,2375793
840,KR,Medium,1965,30-34,1145871,1132998,2278869
840,KR,Medium,1965,35-39,935819,961857,1897676
840,KR,Medium,1965,40-44,714200,789027,1503227
840,KR,Medium,1965,45-49,652785,666120,1318905
840,KR,Medium,1965,05岿 09老,535956,531137,1067093
840,KR,Medium,1965,50-54,443633,465379,909012
840,KR,Medium,1965,55-59,358167,398644,756811
840,KR,Medium,1965,60-64,236043,294344,530387
840,KR,Medium,1965,65-69,174264,229683,403947
840,KR,Medium,1965,70-74,96350,148942,245292
840,KR,Medium,1965,75-79,55662,96288,151950
840,KR,Medium,1965,80+,27086,52808,79894
840,KR,Medium,1966,0-4,2419344,2243390,4662734
840,KR,Medium,1966,10岿 14老,2428011,2258024,4686035
840,KR,Medium,1966,15-19,1845446,1721844,3567290
840,KR,Medium,1966,20-24,1380929,1316598,2697527
840,KR,Medium,1966,25-29,1216523,1128542,2345065
840,KR,Medium,1966,30-34,1163475,1155506,2318981
840,KR,Medium,1966,35-39,992511,1001834,1994345
840,KR,Medium,1966,40-44,741232,817072,1558304
840,KR,Medium,1966,45-49,648791,679581,1328372
840,KR,Medium,1966,05岿 09老,551738,546425,1098163
840,KR,Medium,1966,50-54,456513,477328,933841
840,KR,Medium,1966,55-59,370877,407861,778738
840,KR,Medium,1966,60-64,242419,297123,539542
840,KR,Medium,1966,65-69,184531,241305,425836
840,KR,Medium,1966,70-74,101220,158980,260200
840,KR,Medium,1966,75-79,57915,99349,157264
840,KR,Medium,1966,80+,28386,54948,83334
840,KR,Medium,1967,0-4,2402855,2219142,4621997
840,KR,Medium,1967,10岿 14老,2477814,2305798,4783612
840,KR,Medium,1967,15-19,1963670,1830214,3793884
840,KR,Medium,1967,20-24,1428209,1354475,2782684
840,KR,Medium,1967,25-29,1233220,1134440,2367660
840,KR,Medium,1967,30-34,1182153,1170449,2352602
840,KR,Medium,1967,35-39,1042065,1038291,2080356
840,KR,Medium,1967,40-44,771926,852822,1624748
840,KR,Medium,1967,45-49,653268,691904,1345172
840,KR,Medium,1967,05岿 09老,572071,567781,1139852
840,KR,Medium,1967,50-54,466761,488305,955066
840,KR,Medium,1967,55-59,382888,419782,802670
840,KR,Medium,1967,60-64,248040,304716,552756
840,KR,Medium,1967,65-69,188260,246217,434477
840,KR,Medium,1967,70-74,106623,150465,257088
840,KR,Medium,1967,75-79,56172,94426,150598
840,KR,Medium,1967,80+,29398,56363,85761
840,KR,Medium,1968,0-4,2378659,2202652,4581311
840,KR,Medium,1968,10岿 14老,2493776,2319092,4812868
840,KR,Medium,1968,15-19,2105819,1959385,4065204
840,KR,Medium,1968,20-24,1471923,1386459,2858382
840,KR,Medium,1968,25-29,1268677,1173580,2442257
840,KR,Medium,1968,30-34,1185423,1164303,2349726
840,KR,Medium,1968,35-39,1086199,1071601,2157800
840,KR,Medium,1968,40-44,817300,884874,1702174
840,KR,Medium,1968,45-49,656236,709845,1366081
840,KR,Medium,1968,05岿 09老,598864,599069,1197933
840,KR,Medium,1968,50-54,472555,491684,964239
840,KR,Medium,1968,55-59,391433,429795,821228
840,KR,Medium,1968,60-64,263762,322400,586162
840,KR,Medium,1968,65-69,185683,242646,428329
840,KR,Medium,1968,70-74,114381,153739,268120
840,KR,Medium,1968,75-79,53518,91603,145121
840,KR,Medium,1968,80+,31890,59477,91367
840,KR,Medium,1969,0-4,2363493,2198556,4562049
840,KR,Medium,1969,10岿 14老,2460340,2285579,4745919
840,KR,Medium,1969,15-19,2245241,2085023,4330264
840,KR,Medium,1969,20-24,1556114,1460520,3016634
840,KR,Medium,1969,25-29,1288141,1214175,2502316
840,KR,Medium,1969,30-34,1199511,1151340,2350851
840,KR,Medium,1969,35-39,1115419,1091533,2206952
840,KR,Medium,1969,40-44,864561,912899,1777460
840,KR,Medium,1969,45-49,676632,744040,1420672
840,KR,Medium,1969,05岿 09老,614673,624409,1239082
840,KR,Medium,1969,50-54,482998,495429,978427
840,KR,Medium,1969,55-59,395092,435448,830540
840,KR,Medium,1969,60-64,287157,347400,634557
840,KR,Medium,1969,65-69,186153,242669,428822
840,KR,Medium,1969,70-74,117573,161327,278900
840,KR,Medium,1969,75-79,54878,90138,145016
840,KR,Medium,1969,80+,32989,62816,95805
840,KR,Medium,1970,0-4,2362393,2185784,4548177
840,KR,Medium,1970,10岿 14老,2400902,2228980,4629882
840,KR,Medium,1970,15-19,2349947,2181361,4531308
840,KR,Medium,1970,20-24,1688217,1581139,3269356
840,KR,Medium,1970,25-29,1314867,1254177,2569044
840,KR,Medium,1970,30-34,1207106,1128863,2335969
840,KR,Medium,1970,35-39,1129990,1107757,2237747
840,KR,Medium,1970,40-44,920441,946541,1866982
840,KR,Medium,1970,45-49,695800,771329,1467129
840,KR,Medium,1970,05岿 09老,623917,647637,1271554
840,KR,Medium,1970,50-54,504235,512915,1017150
840,KR,Medium,1970,55-59,403184,443264,846448
840,KR,Medium,1970,60-64,299491,359282,658773
840,KR,Medium,1970,65-69,178840,249885,428725
840,KR,Medium,1970,70-74,139249,172559,311808
840,KR,Medium,1970,75-79,56261,93589,149850
840,KR,Medium,1970,80+,33767,67158,100925
840,KR,Medium,1971,0-4,2412538,2207043,4619581
840,KR,Medium,1971,10岿 14老,2351739,2173132,4524871
840,KR,Medium,1971,15-19,2396532,2223105,4619637
840,KR,Medium,1971,20-24,1809311,1690605,3499916
840,KR,Medium,1971,25-29,1349350,1291625,2640975
840,KR,Medium,1971,30-34,1193169,1104590,2297759
840,KR,Medium,1971,35-39,1148290,1120701,2268991
840,KR,Medium,1971,40-44,971765,976799,1948564
840,KR,Medium,1971,45-49,718462,800106,1518568
840,KR,Medium,1971,05岿 09老,626273,662659,1288932
840,KR,Medium,1971,50-54,514448,526610,1041058
840,KR,Medium,1971,55-59,416503,457981,874484
840,KR,Medium,1971,60-64,312145,372700,684845
840,KR,Medium,1971,65-69,196448,270583,467031
840,KR,Medium,1971,70-74,136981,184812,321793
840,KR,Medium,1971,75-79,60229,102268,162497
840,KR,Medium,1971,80+,34701,68501,103202
840,KR,Medium,1972,0-4,2447126,2228379,4675505
840,KR,Medium,1972,10岿 14老,2317049,2140397,4457446
840,KR,Medium,1972,15-19,2451025,2274496,4725521
840,KR,Medium,1972,20-24,1926265,1797182,3723447
840,KR,Medium,1972,25-29,1397225,1332263,2729488
840,KR,Medium,1972,30-34,1194881,1115073,2309954
840,KR,Medium,1972,35-39,1166998,1139037,2306035
840,KR,Medium,1972,40-44,1020101,1008968,2029069
840,KR,Medium,1972,45-49,743874,831324,1575198
840,KR,Medium,1972,05岿 09老,622886,672662,1295548
840,KR,Medium,1972,50-54,528379,543264,1071643
840,KR,Medium,1972,55-59,413697,458865,872562
840,KR,Medium,1972,60-64,313400,375932,689332
840,KR,Medium,1972,65-69,188800,266636,455436
840,KR,Medium,1972,70-74,130081,188283,318364
840,KR,Medium,1972,75-79,58837,105489,164326
840,KR,Medium,1972,80+,34814,71718,106532
840,KR,Medium,1973,0-4,2458932,2236381,4695313
840,KR,Medium,1973,10岿 14老,2289895,2123629,4413524
840,KR,Medium,1973,15-19,2460133,2280415,4740548
840,KR,Medium,1973,20-24,2046212,1913894,3960106
840,KR,Medium,1973,25-29,1421584,1358803,2780387
840,KR,Medium,1973,30-34,1223388,1155037,2378425
840,KR,Medium,1973,35-39,1162405,1134064,2296469
840,KR,Medium,1973,40-44,1066617,1041692,2108309
840,KR,Medium,1973,45-49,781933,860784,1642717
840,KR,Medium,1973,05岿 09老,623922,690850,1314772
840,KR,Medium,1973,50-54,550741,571706,1122447
840,KR,Medium,1973,55-59,413557,461059,874616
840,KR,Medium,1973,60-64,317671,380591,698262
840,KR,Medium,1973,65-69,197881,278686,476567
840,KR,Medium,1973,70-74,123544,193449,316993
840,KR,Medium,1973,75-79,60479,111763,172242
840,KR,Medium,1973,80+,35983,75469,111452
840,KR,Medium,1974,0-4,2455536,2233746,4689282
840,KR,Medium,1974,10岿 14老,2289501,2133086,4422587
840,KR,Medium,1974,15-19,2429491,2248711,4678202
840,KR,Medium,1974,20-24,2157237,2017314,4174551
840,KR,Medium,1974,25-29,1468221,1406296,2874517
840,KR,Medium,1974,30-34,1257320,1200895,2458215
840,KR,Medium,1974,35-39,1154727,1122787,2277514
840,KR,Medium,1974,40-44,1100456,1065566,2166022
840,KR,Medium,1974,45-49,828202,891805,1720007
840,KR,Medium,1974,05岿 09老,635119,717636,1352755
840,KR,Medium,1974,50-54,569661,599436,1169097
840,KR,Medium,1974,55-59,421197,469290,890487
840,KR,Medium,1974,60-64,317665,380855,698520
840,KR,Medium,1974,65-69,214018,297437,511455
840,KR,Medium,1974,70-74,117351,193268,310619
840,KR,Medium,1974,75-79,62222,119401,181623
840,KR,Medium,1974,80+,36299,80514,116813
840,KR,Medium,1975,0-4,2373560,2167499,4541059
840,KR,Medium,1975,10岿 14老,2319163,2158996,4478159
840,KR,Medium,1975,15-19,2384577,2210608,4595185
840,KR,Medium,1975,20-24,2240011,2094258,4334269
840,KR,Medium,1975,25-29,1570423,1503991,3074414
840,KR,Medium,1975,30-34,1289827,1245439,2535266
840,KR,Medium,1975,35-39,1137048,1108634,2245682
840,KR,Medium,1975,40-44,1123445,1085681,2209126
840,KR,Medium,1975,45-49,887724,932497,1820221
840,KR,Medium,1975,05岿 09老,650006,748393,1398399
840,KR,Medium,1975,50-54,580476,622471,1202947
840,KR,Medium,1975,55-59,435319,484062,919381
840,KR,Medium,1975,60-64,320952,388218,709170
840,KR,Medium,1975,65-69,225695,312711,538406
840,KR,Medium,1975,70-74,121921,213140,335061
840,KR,Medium,1975,75-79,68485,136655,205140
840,KR,Medium,1975,80+,37196,101644,138840
840,KR,Medium,1976,0-4,2277734,2102367,4380101
840,KR,Medium,1976,10岿 14老,2357566,2183011,4540577
840,KR,Medium,1976,15-19,2342590,2171562,4514152
840,KR,Medium,1976,20-24,2301340,2153668,4455008
840,KR,Medium,1976,25-29,1711349,1625176,3336525
840,KR,Medium,1976,30-34,1317288,1271119,2588407
840,KR,Medium,1976,35-39,1140414,1096220,2236634
840,KR,Medium,1976,40-44,1144977,1106066,2251043
840,KR,Medium,1976,45-49,949159,964647,1913806
840,KR,Medium,1976,05岿 09老,670994,777891,1448885
840,KR,Medium,1976,50-54,584284,640519,1224803
840,KR,Medium,1976,55-59,452778,499087,951865
840,KR,Medium,1976,60-64,336620,407984,744604
840,KR,Medium,1976,65-69,233858,323160,557018
840,KR,Medium,1976,70-74,128280,217260,345540
840,KR,Medium,1976,75-79,71525,144367,215892
840,KR,Medium,1976,80+,37747,105916,143663
840,KR,Medium,1977,0-4,2189998,2032844,4222842
840,KR,Medium,1977,10岿 14老,2395908,2215771,4611679
840,KR,Medium,1977,15-19,2302362,2136224,4438586
840,KR,Medium,1977,20-24,2350952,2195834,4546786
840,KR,Medium,1977,25-29,1814081,1730467,3544548
840,KR,Medium,1977,30-34,1354062,1293901,2647963
840,KR,Medium,1977,35-39,1169762,1108456,2278218
840,KR,Medium,1977,40-44,1166571,1126875,2293446
840,KR,Medium,1977,45-49,1002288,992748,1995036
840,KR,Medium,1977,05岿 09老,704404,808496,1512900
840,KR,Medium,1977,50-54,585688,657383,1243071
840,KR,Medium,1977,55-59,473166,520229,993395
840,KR,Medium,1977,60-64,349839,424128,773967
840,KR,Medium,1977,65-69,243781,334081,577862
840,KR,Medium,1977,70-74,133976,223699,357675
840,KR,Medium,1977,75-79,73696,149380,223076
840,KR,Medium,1977,80+,38882,111863,150745
840,KR,Medium,1978,0-4,2122886,1984224,4107110
840,KR,Medium,1978,10岿 14老,2408848,2217987,4626835
840,KR,Medium,1978,15-19,2269220,2112864,4382084
840,KR,Medium,1978,20-24,2384182,2219836,4604018
840,KR,Medium,1978,25-29,1903754,1840020,3743774
840,KR,Medium,1978,30-34,1407774,1319532,2727306
840,KR,Medium,1978,35-39,1215645,1140313,2355958
840,KR,Medium,1978,40-44,1177062,1133578,2310640
840,KR,Medium,1978,45-49,1047568,1021777,2069345
840,KR,Medium,1978,05岿 09老,747213,835910,1583123
840,KR,Medium,1978,50-54,587255,674345,1261600
840,KR,Medium,1978,55-59,498041,549123,1047164
840,KR,Medium,1978,60-64,359231,433835,793066
840,KR,Medium,1978,65-69,251992,344354,596346
840,KR,Medium,1978,70-74,142897,235418,378315
840,KR,Medium,1978,75-79,72632,150410,223042
840,KR,Medium,1978,80+,41054,118405,159459
840,KR,Medium,1979,0-4,2081358,1943823,4025181
840,KR,Medium,1979,10岿 14老,2383807,2200879,4584686
840,KR,Medium,1979,15-19,2273652,2121796,4395448
840,KR,Medium,1979,20-24,2378013,2209512,4587525
840,KR,Medium,1979,25-29,1992601,1943918,3936519
840,KR,Medium,1979,30-34,1485232,1377009,2862241
840,KR,Medium,1979,35-39,1270576,1175924,2446500
840,KR,Medium,1979,40-44,1174643,1125482,2300125
840,KR,Medium,1979,45-49,1083740,1049028,2132768
840,KR,Medium,1979,05岿 09老,797311,862564,1659875
840,KR,Medium,1979,50-54,594640,694651,1289291
840,KR,Medium,1979,55-59,518057,579312,1097369
840,KR,Medium,1979,60-64,369793,441973,811766
840,KR,Medium,1979,65-69,256937,351474,608411
840,KR,Medium,1979,70-74,154087,251294,405381
840,KR,Medium,1979,75-79,71238,150575,221813
840,KR,Medium,1979,80+,43676,125661,169337
840,KR,Medium,1980,0-4,2087411,1946316,4033727
840,KR,Medium,1980,10岿 14老,2314435,2143991,4458426
840,KR,Medium,1980,15-19,2305805,2152817,4458622
840,KR,Medium,1980,20-24,2343977,2175712,4519689
840,KR,Medium,1980,25-29,2078090,2015317,4093407
840,KR,Medium,1980,30-34,1584377,1488420,3072797
840,KR,Medium,1980,35-39,1320116,1205098,2525214
840,KR,Medium,1980,40-44,1168846,1110719,2279565
840,KR,Medium,1980,45-49,1110891,1067679,2178570
840,KR,Medium,1980,05岿 09老,859667,896421,1756088
840,KR,Medium,1980,50-54,607140,717786,1324926
840,KR,Medium,1980,55-59,528205,602630,1130835
840,KR,Medium,1980,60-64,382208,453668,835876
840,KR,Medium,1980,65-69,263454,360503,623957
840,KR,Medium,1980,70-74,162400,263595,425995
840,KR,Medium,1980,75-79,73846,154013,227859
840,KR,Medium,1980,80+,44868,133354,178222
840,KR,Medium,1981,0-4,2109966,1965926,4075892
840,KR,Medium,1981,10岿 14老,2229556,2087082,4316638
840,KR,Medium,1981,15-19,2342517,2189989,4532506
840,KR,Medium,1981,20-24,2286198,2125736,4411934
840,KR,Medium,1981,25-29,2180617,2083708,4264325
840,KR,Medium,1981,30-34,1692645,1607206,3299851
840,KR,Medium,1981,35-39,1353919,1241977,2595896
840,KR,Medium,1981,40-44,1170953,1098311,2269264
840,KR,Medium,1981,45-49,1137936,1088526,2226462
840,KR,Medium,1981,05岿 09老,919177,932094,1851271
840,KR,Medium,1981,50-54,630060,746556,1376616
840,KR,Medium,1981,55-59,529106,615134,1144240
840,KR,Medium,1981,60-64,391953,468221,860174
840,KR,Medium,1981,65-69,271107,369561,640668
840,KR,Medium,1981,70-74,168560,272834,441394
840,KR,Medium,1981,75-79,76421,159218,235639
840,KR,Medium,1981,80+,44989,135489,180478
840,KR,Medium,1982,0-4,2129549,1982810,4112359
840,KR,Medium,1982,10岿 14老,2153742,2014610,4168352
840,KR,Medium,1982,15-19,2378037,2227852,4605889
840,KR,Medium,1982,20-24,2242817,2088285,4331102
840,KR,Medium,1982,25-29,2235847,2134522,4370369
840,KR,Medium,1982,30-34,1790014,1709435,3499449
840,KR,Medium,1982,35-39,1398963,1283330,2682293
840,KR,Medium,1982,40-44,1192121,1105974,2298095
840,KR,Medium,1982,45-49,1163656,1110551,2274207
840,KR,Medium,1982,05岿 09老,965593,962786,1928379
840,KR,Medium,1982,50-54,666215,777972,1444187
840,KR,Medium,1982,55-59,530231,628849,1159080
840,KR,Medium,1982,60-64,405033,488143,893176
840,KR,Medium,1982,65-69,279657,378995,658652
840,KR,Medium,1982,70-74,175629,284084,459713
840,KR,Medium,1982,75-79,83840,170294,254134
840,KR,Medium,1982,80+,46448,140468,186916
840,KR,Medium,1983,0-4,2136203,1983512,4119715
840,KR,Medium,1983,10岿 14老,2096080,1960725,4056805
840,KR,Medium,1983,15-19,2386003,2238445,4624448
840,KR,Medium,1983,20-24,2226838,2077982,4304820
840,KR,Medium,1983,25-29,2244086,2149399,4393485
840,KR,Medium,1983,30-34,1893189,1820376,3713565
840,KR,Medium,1983,35-39,1460106,1327562,2787668
840,KR,Medium,1983,40-44,1232128,1137114,2369242
840,KR,Medium,1983,45-49,1172788,1116252,2289040
840,KR,Medium,1983,05岿 09老,1007134,994652,2001786
840,KR,Medium,1983,50-54,710345,807529,1517874
840,KR,Medium,1983,55-59,535138,646509,1181647
840,KR,Medium,1983,60-64,421952,513822,935774
840,KR,Medium,1983,65-69,287396,386867,674263
840,KR,Medium,1983,70-74,181807,293362,475169
840,KR,Medium,1983,75-79,89588,180815,270403
840,KR,Medium,1983,80+,48339,146360,194699
840,KR,Medium,1984,0-4,2084255,1928889,4013144
840,KR,Medium,1984,10岿 14老,2060357,1930173,3990530
840,KR,Medium,1984,15-19,2366607,2221479,4588086
840,KR,Medium,1984,20-24,2240935,2098219,4339154
840,KR,Medium,1984,25-29,2218868,2128638,4347506
840,KR,Medium,1984,30-34,1992653,1924720,3917373
840,KR,Medium,1984,35-39,1540638,1396598,2937236
840,KR,Medium,1984,40-44,1282221,1180667,2462888
840,KR,Medium,1984,45-49,1168830,1107894,2276724
840,KR,Medium,1984,05岿 09老,1043789,1022682,2066471
840,KR,Medium,1984,50-54,760825,839392,1600217
840,KR,Medium,1984,55-59,546814,668597,1215411
840,KR,Medium,1984,60-64,437544,540057,977601
840,KR,Medium,1984,65-69,294903,395836,690739
840,KR,Medium,1984,70-74,188216,301002,489218
840,KR,Medium,1984,75-79,96046,192239,288285
840,KR,Medium,1984,80+,51674,153699,205373
840,KR,Medium,1985,0-4,1995049,1850484,3845533
840,KR,Medium,1985,10岿 14老,2046870,1920797,3967667
840,KR,Medium,1985,15-19,2316422,2174920,4491342
840,KR,Medium,1985,20-24,2272313,2135464,4407777
840,KR,Medium,1985,25-29,2185328,2089009,4274337
840,KR,Medium,1985,30-34,2092942,2004949,4097891
840,KR,Medium,1985,35-39,1626661,1462611,3089272
840,KR,Medium,1985,40-44,1314595,1237597,2552192
840,KR,Medium,1985,45-49,1165918,1096983,2262901
840,KR,Medium,1985,05岿 09老,1073822,1045518,2119340
840,KR,Medium,1985,50-54,814133,872627,1686760
840,KR,Medium,1985,55-59,564617,693961,1258578
840,KR,Medium,1985,60-64,449283,561022,1010305
840,KR,Medium,1985,65-69,303471,408737,712208
840,KR,Medium,1985,70-74,197029,309324,506353
840,KR,Medium,1985,75-79,103369,204739,308108
840,KR,Medium,1985,80+,53778,161402,215180
840,KR,Medium,1986,0-4,1908721,1756018,3664739
840,KR,Medium,1986,10岿 14老,2073931,1943319,4017250
840,KR,Medium,1986,15-19,2243103,2104741,4347844
840,KR,Medium,1986,20-24,2308439,2173491,4481930
840,KR,Medium,1986,25-29,2179523,2066122,4245645
840,KR,Medium,1986,30-34,2140451,2065715,4206166
840,KR,Medium,1986,35-39,1726765,1617868,3344633
840,KR,Medium,1986,40-44,1341391,1222938,2564329
840,KR,Medium,1986,45-49,1165761,1094033,2259794
840,KR,Medium,1986,05岿 09老,1099493,1067449,2166942
840,KR,Medium,1986,50-54,863615,908413,1772028
840,KR,Medium,1986,55-59,586187,720283,1306470
840,KR,Medium,1986,60-64,456346,578822,1035168
840,KR,Medium,1986,65-69,314236,425134,739370
840,KR,Medium,1986,70-74,201682,316059,517741
840,KR,Medium,1986,75-79,105534,211828,317362
840,KR,Medium,1986,80+,56819,169444,226263
840,KR,Medium,1987,0-4,1806973,1662889,3469862
840,KR,Medium,1987,10岿 14老,2109423,1973804,4083227
840,KR,Medium,1987,15-19,2163735,2029553,4193288
840,KR,Medium,1987,20-24,2342692,2207280,4549972
840,KR,Medium,1987,25-29,2161770,2046142,4207912
840,KR,Medium,1987,30-34,2184804,2106788,4291592
840,KR,Medium,1987,35-39,1810698,1718664,3529362
840,KR,Medium,1987,40-44,1383009,1264675,2647684
840,KR,Medium,1987,45-49,1176211,1106082,2282293
840,KR,Medium,1987,05岿 09老,1123269,1088249,2211518
840,KR,Medium,1987,50-54,911411,941455,1852866
840,KR,Medium,1987,55-59,618856,750876,1369732
840,KR,Medium,1987,60-64,460271,595683,1055954
840,KR,Medium,1987,65-69,328403,445959,774362
840,KR,Medium,1987,70-74,208766,326889,535655
840,KR,Medium,1987,75-79,109645,218764,328409
840,KR,Medium,1987,80+,60044,177958,238002
840,KR,Medium,1988,0-4,1741382,1589371,3330753
840,KR,Medium,1988,10岿 14老,2123004,1986263,4109267
840,KR,Medium,1988,15-19,2088582,1958843,4047425
840,KR,Medium,1988,20-24,2358183,2223167,4581350
840,KR,Medium,1988,25-29,2144822,2032746,4177568
840,KR,Medium,1988,30-34,2215868,2130915,4346783
840,KR,Medium,1988,35-39,1921027,1835282,3756309
840,KR,Medium,1988,40-44,1406584,1296670,2703254
840,KR,Medium,1988,45-49,1201983,1135674,2337657
840,KR,Medium,1988,05岿 09老,1132978,1097349,2230327
840,KR,Medium,1988,50-54,957429,970137,1927566
840,KR,Medium,1988,55-59,657283,784223,1441506
840,KR,Medium,1988,60-64,465153,614469,1079622
840,KR,Medium,1988,65-69,346607,470051,816658
840,KR,Medium,1988,70-74,215339,338528,553867
840,KR,Medium,1988,75-79,115578,225494,341072
840,KR,Medium,1988,80+,63424,186839,250263
840,KR,Medium,1989,0-4,1722889,1554953,3277842
840,KR,Medium,1989,10岿 14老,2078155,1943648,4021803
840,KR,Medium,1989,15-19,2043883,1917603,3961486
840,KR,Medium,1989,20-24,2341468,2209053,4550521
840,KR,Medium,1989,25-29,2160951,2047375,4208326
840,KR,Medium,1989,30-34,2215298,2127003,4342301
840,KR,Medium,1989,35-39,2023780,1942221,3966001
840,KR,Medium,1989,40-44,1453648,1352324,2805972
840,KR,Medium,1989,45-49,1241917,1177254,2419171
840,KR,Medium,1989,05岿 09老,1127174,1092071,2219245
840,KR,Medium,1989,50-54,997839,997147,1994986
840,KR,Medium,1989,55-59,698631,817967,1516598
840,KR,Medium,1989,60-64,475876,635925,1111801
840,KR,Medium,1989,65-69,367064,498989,866053
840,KR,Medium,1989,70-74,222274,348366,570640
840,KR,Medium,1989,75-79,119565,233635,353200
840,KR,Medium,1989,80+,66977,196115,263092
840,KR,Medium,1990,0-4,1687147,1516056,3203203
840,KR,Medium,1990,10岿 14老,1991341,1852140,3843481
840,KR,Medium,1990,15-19,2029056,1897852,3926908
840,KR,Medium,1990,20-24,2289382,2152632,4442014
840,KR,Medium,1990,25-29,2237534,2104873,4342407
840,KR,Medium,1990,30-34,2222615,2104134,4326749
840,KR,Medium,1990,35-39,2123583,2011119,4134702
840,KR,Medium,1990,40-44,1562784,1479545,3042329
840,KR,Medium,1990,45-49,1268797,1208951,2477748
840,KR,Medium,1990,05岿 09老,1100340,1066369,2166709
840,KR,Medium,1990,50-54,1001442,1020272,2021714
840,KR,Medium,1990,55-59,739200,850304,1589504
840,KR,Medium,1990,60-64,493103,663628,1156731
840,KR,Medium,1990,65-69,375468,525383,900851
840,KR,Medium,1990,70-74,234292,364560,598852
840,KR,Medium,1990,75-79,132365,260764,393129
840,KR,Medium,1990,80+,79732,222520,302252
840,KR,Medium,1991,0-4,1711889,1526977,3238866
840,KR,Medium,1991,10岿 14老,1892414,1752238,3644652
840,KR,Medium,1991,15-19,2052888,1922314,3975202
840,KR,Medium,1991,20-24,2215342,2081699,4297041
840,KR,Medium,1991,25-29,2282016,2147005,4429021
840,KR,Medium,1991,30-34,2189388,2074617,4264005
840,KR,Medium,1991,35-39,2187801,2071235,4259036
840,KR,Medium,1991,40-44,1679109,1594562,3273671
840,KR,Medium,1991,45-49,1301987,1243808,2545795
840,KR,Medium,1991,05岿 09老,1095429,1060037,2155466
840,KR,Medium,1991,50-54,1024861,1041324,2066185
840,KR,Medium,1991,55-59,788855,885534,1674389
840,KR,Medium,1991,60-64,515094,690840,1205934
840,KR,Medium,1991,65-69,379487,539617,919104
840,KR,Medium,1991,70-74,242700,376332,619032
840,KR,Medium,1991,75-79,140919,270466,411385
840,KR,Medium,1991,80+,83735,233185,316920
840,KR,Medium,1992,0-4,1760364,1555810,3316174
840,KR,Medium,1992,10岿 14老,1790092,1650813,3440905
840,KR,Medium,1992,15-19,2082673,1951674,4034347
840,KR,Medium,1992,20-24,2134720,2004038,4138758
840,KR,Medium,1992,25-29,2319533,2184965,4504498
840,KR,Medium,1992,30-34,2165343,2051475,4216818
840,KR,Medium,1992,35-39,2232004,2113010,4345014
840,KR,Medium,1992,40-44,1787559,1701514,3489073
840,KR,Medium,1992,45-49,1332496,1275865,2608361
840,KR,Medium,1992,05岿 09老,1107613,1072672,2180285
840,KR,Medium,1992,50-54,1049469,1061757,2111226
840,KR,Medium,1992,55-59,832888,916315,1749203
840,KR,Medium,1992,60-64,545528,721916,1267444
840,KR,Medium,1992,65-69,384640,554235,938875
840,KR,Medium,1992,70-74,254547,394923,649470
840,KR,Medium,1992,75-79,146260,279000,425260
840,KR,Medium,1992,80+,87926,244325,332251
840,KR,Medium,1993,0-4,1812752,1590381,3403133
840,KR,Medium,1993,10岿 14老,1711765,1569336,3281101
840,KR,Medium,1993,15-19,2090973,1959321,4050294
840,KR,Medium,1993,20-24,2062442,1934137,3996579
840,KR,Medium,1993,25-29,2331611,2199686,4531297
840,KR,Medium,1993,30-34,2159527,2044119,4203646
840,KR,Medium,1993,35-39,2247695,2129033,4376728
840,KR,Medium,1993,40-44,1900657,1811408,3712065
840,KR,Medium,1993,45-49,1366473,1310383,2676856
840,KR,Medium,1993,05岿 09老,1140436,1106197,2246633
840,KR,Medium,1993,50-54,1058595,1067472,2126067
840,KR,Medium,1993,55-59,873455,946810,1820265
840,KR,Medium,1993,60-64,581164,751807,1332971
840,KR,Medium,1993,65-69,393008,572296,965304
840,KR,Medium,1993,70-74,269882,420774,690656
840,KR,Medium,1993,75-79,149838,283042,432880
840,KR,Medium,1993,80+,92281,255872,348153
840,KR,Medium,1994,0-4,1859029,1624254,3483283
840,KR,Medium,1994,10岿 14老,1671042,1520622,3191664
840,KR,Medium,1994,15-19,2055540,1922959,3978499
840,KR,Medium,1994,20-24,2017721,1891953,3909674
840,KR,Medium,1994,25-29,2310177,2180962,4491139
840,KR,Medium,1994,30-34,2177475,2059594,4237069
840,KR,Medium,1994,35-39,2234505,2118539,4353044
840,KR,Medium,1994,40-44,2009543,1915369,3924912
840,KR,Medium,1994,45-49,1426899,1369828,2796727
840,KR,Medium,1994,05岿 09老,1184655,1150796,2335451
840,KR,Medium,1994,50-54,1053212,1058177,2111389
840,KR,Medium,1994,55-59,907157,974738,1881895
840,KR,Medium,1994,60-64,622405,781897,1404302
840,KR,Medium,1994,65-69,406538,596180,1002718
840,KR,Medium,1994,70-74,285254,447930,733184
840,KR,Medium,1994,75-79,154503,287313,441816
840,KR,Medium,1994,80+,96841,267933,364774
840,KR,Medium,1995,0-4,1893876,1651828,3545704
840,KR,Medium,1995,10岿 14老,1664291,1502462,3166753
840,KR,Medium,1995,15-19,1978698,1845673,3824371
840,KR,Medium,1995,20-24,2010189,1886759,3896948
840,KR,Medium,1995,25-29,2259595,2132031,4391626
840,KR,Medium,1995,30-34,2210162,2090548,4300710
840,KR,Medium,1995,35-39,2204571,2092150,4296721
840,KR,Medium,1995,40-44,2095913,1996138,4092051
840,KR,Medium,1995,45-49,1527547,1467844,2995391
840,KR,Medium,1995,05岿 09老,1225938,1192966,2418904
840,KR,Medium,1995,50-54,1045400,1045311,2090711
840,KR,Medium,1995,55-59,932110,995816,1927926
840,KR,Medium,1995,60-64,670698,817825,1488523
840,KR,Medium,1995,65-69,424965,623249,1048214
840,KR,Medium,1995,70-74,297065,469728,766793
840,KR,Medium,1995,75-79,162677,296749,459426
840,KR,Medium,1995,80+,101634,280585,382219
840,KR,Medium,1996,0-4,1895407,1663666,3559073
840,KR,Medium,1996,10岿 14老,1689685,1498797,3188482
840,KR,Medium,1996,15-19,1899255,1756467,3655722
840,KR,Medium,1996,20-24,2030805,1922711,3953516
840,KR,Medium,1996,25-29,2194125,2053328,4247453
840,KR,Medium,1996,30-34,2222172,2122321,4344493
840,KR,Medium,1996,35-39,2187039,2070461,4257500
840,KR,Medium,1996,40-44,2148707,2055375,4204082
840,KR,Medium,1996,45-49,1641684,1575793,3217477
840,KR,Medium,1996,05岿 09老,1266396,1211896,2478292
840,KR,Medium,1996,50-54,1040241,1034625,2074866
840,KR,Medium,1996,55-59,947145,1014089,1961234
840,KR,Medium,1996,60-64,719920,867689,1587609
840,KR,Medium,1996,65-69,449576,650596,1100172
840,KR,Medium,1996,70-74,305777,482888,788665
840,KR,Medium,1996,75-79,171472,312749,484221
840,KR,Medium,1996,80+,115106,306718,421824
840,KR,Medium,1997,0-4,1872827,1651248,3524075
840,KR,Medium,1997,10岿 14老,1736754,1533243,3269997
840,KR,Medium,1997,15-19,1793390,1645640,3439030
840,KR,Medium,1997,20-24,2070863,1960903,4031766
840,KR,Medium,1997,25-29,2111495,1966071,4077566
840,KR,Medium,1997,30-34,2258208,2166011,4424219
840,KR,Medium,1997,35-39,2172352,2039837,4212189
840,KR,Medium,1997,40-44,2198346,2114453,4312799
840,KR,Medium,1997,45-49,1742628,1662595,3405223
840,KR,Medium,1997,05岿 09老,1301587,1252000,2553587
840,KR,Medium,1997,50-54,1060928,1042467,2103395
840,KR,Medium,1997,55-59,970309,1041013,2011322
840,KR,Medium,1997,60-64,763853,895248,1659101
840,KR,Medium,1997,65-69,477897,686812,1164709
840,KR,Medium,1997,70-74,313712,499887,813599
840,KR,Medium,1997,75-79,181842,327656,509498
840,KR,Medium,1997,80+,121101,320404,441505
840,KR,Medium,1998,0-4,1829498,1623310,3452808
840,KR,Medium,1998,10岿 14老,1792374,1574956,3367330
840,KR,Medium,1998,15-19,1711884,1559495,3271379
840,KR,Medium,1998,20-24,2088473,1972151,4060624
840,KR,Medium,1998,25-29,2034268,1903816,3938084
840,KR,Medium,1998,30-34,2261150,2179897,4441047
840,KR,Medium,1998,35-39,2148305,2013992,4162297
840,KR,Medium,1998,40-44,2210902,2147046,4357948
840,KR,Medium,1998,45-49,1853383,1772055,3625438
840,KR,Medium,1998,05岿 09老,1330322,1282892,2613214
840,KR,Medium,1998,50-54,1099849,1074104,2173953
840,KR,Medium,1998,55-59,980344,1048696,2029040
840,KR,Medium,1998,60-64,799938,924350,1724288
840,KR,Medium,1998,65-69,512154,717748,1229902
840,KR,Medium,1998,70-74,323974,518663,842637
840,KR,Medium,1998,75-79,192944,347431,540375
840,KR,Medium,1998,80+,125965,330174,456139
840,KR,Medium,1999,0-4,1766586,1582587,3349173
840,KR,Medium,1999,10岿 14老,1842718,1616434,3459152
840,KR,Medium,1999,15-19,1662899,1501670,3164569
840,KR,Medium,1999,20-24,2062556,1936599,3999155
840,KR,Medium,1999,25-29,1992175,1861266,3853441
840,KR,Medium,1999,30-34,2252178,2166175,4418353
840,KR,Medium,1999,35-39,2150092,2031533,4181625
840,KR,Medium,1999,40-44,2199114,2125831,4324945
840,KR,Medium,1999,45-49,1964249,1895918,3860167
840,KR,Medium,1999,05岿 09老,1383436,1332659,2716095
840,KR,Medium,1999,50-54,1149801,1120450,2270251
840,KR,Medium,1999,55-59,979909,1036565,2016474
840,KR,Medium,1999,60-64,828732,950969,1779701
840,KR,Medium,1999,65-69,551423,746670,1298093
840,KR,Medium,1999,70-74,337200,543965,881165
840,KR,Medium,1999,75-79,204497,371995,576492
840,KR,Medium,1999,80+,130272,337554,467826
840,KR,Medium,2000,0-4,1716148,1543635,3259783
840,KR,Medium,2000,10岿 14老,1877208,1644256,3521464
840,KR,Medium,2000,100+,1651269,1478713,3129982
840,KR,Medium,2000,15-19,1987021,1855411,3842432
840,KR,Medium,2000,20-24,1989852,1864530,3854382
840,KR,Medium,2000,25-29,2232158,2120755,4352913
840,KR,Medium,2000,30-34,2176913,2071079,4247992
840,KR,Medium,2000,35-39,2180572,2092507,4273079
840,KR,Medium,2000,40-44,2045158,1975280,4020438
840,KR,Medium,2000,45-49,1483122,1438321,2921443
840,KR,Medium,2000,05岿 09老,1194103,1171759,2365862
840,KR,Medium,2000,50-54,981156,1025233,2006389
840,KR,Medium,2000,55-59,852303,964753,1817056
840,KR,Medium,2000,60-64,595086,786126,1381212
840,KR,Medium,2000,65-69,353411,568802,922213
840,KR,Medium,2000,70-74,215420,392664,608084
840,KR,Medium,2000,75-79,135869,347518,483387
840,KR,Medium,2000,80-84,95912,214202,310114
840,KR,Medium,2000,85-89,31792,96605,128397
840,KR,Medium,2000,90-94,7115,30024,37139
840,KR,Medium,2000,95-99,966,5792,6758
840,KR,Medium,2001,0-4,1658958,1503900,3162858
840,KR,Medium,2001,10岿 14老,1881924,1651084,3533008
840,KR,Medium,2001,100+,1671109,1485477,3156586
840,KR,Medium,2001,15-19,1876518,1739011,3615529
840,KR,Medium,2001,20-24,2025970,1907265,3933235
840,KR,Medium,2001,25-29,2179040,2045556,4224596
840,KR,Medium,2001,30-34,2213068,2119019,4332087
840,KR,Medium,2001,35-39,2166558,2062407,4228965
840,KR,Medium,2001,40-44,2113646,2041639,4155285
840,KR,Medium,2001,45-49,1598458,1562163,3160621
840,KR,Medium,2001,05岿 09老,1224816,1202721,2427537
840,KR,Medium,2001,50-54,990089,1018848,2008937
840,KR,Medium,2001,55-59,875583,984412,1859995
840,KR,Medium,2001,60-64,637330,823763,1461093
840,KR,Medium,2001,65-69,371625,592322,963947
840,KR,Medium,2001,70-74,224127,405729,629856
840,KR,Medium,2001,75-79,146152,369877,516029
840,KR,Medium,2001,80-84,102574,227037,329611
840,KR,Medium,2001,85-89,34821,104046,138867
840,KR,Medium,2001,90-94,7634,31529,39163
840,KR,Medium,2001,95-99,1026,6268,7294
840,KR,Medium,2002,0-4,1573834,1432527,3006361
840,KR,Medium,2002,10岿 14老,1858210,1636050,3494260
840,KR,Medium,2002,100+,1714089,1517638,3231727
840,KR,Medium,2002,15-19,1765454,1625789,3391243
840,KR,Medium,2002,20-24,2066245,1945084,4011329
840,KR,Medium,2002,25-29,2098801,1965788,4064589
840,KR,Medium,2002,30-34,2255001,2166319,4421320
840,KR,Medium,2002,35-39,2153573,2033933,4187506
840,KR,Medium,2002,40-44,2169132,2102133,4271265
840,KR,Medium,2002,45-49,1697943,1648190,3346133
840,KR,Medium,2002,05岿 09老,1261221,1244370,2505591
840,KR,Medium,2002,50-54,1012176,1028871,2041047
840,KR,Medium,2002,55-59,901451,1013969,1915420
840,KR,Medium,2002,60-64,676884,851230,1528114
840,KR,Medium,2002,65-69,396315,626942,1023257
840,KR,Medium,2002,70-74,232732,421671,654403
840,KR,Medium,2002,75-79,158316,392855,551171
840,KR,Medium,2002,80-84,110728,239537,350265
840,KR,Medium,2002,85-89,38111,112397,150508
840,KR,Medium,2002,90-94,8266,33200,41466
840,KR,Medium,2002,95-99,1092,6612,7704
840,KR,Medium,2003,0-4,1488560,1354562,2843122
840,KR,Medium,2003,10岿 14老,1808293,1608093,3416386
840,KR,Medium,2003,100+,1767832,1557566,3325398
840,KR,Medium,2003,15-19,1680219,1536701,3216920
840,KR,Medium,2003,20-24,2087878,1957691,4045569
840,KR,Medium,2003,25-29,2036930,1904500,3941430
840,KR,Medium,2003,30-34,2285705,2187307,4473012
840,KR,Medium,2003,35-39,2142489,2012361,4154850
840,KR,Medium,2003,40-44,2201473,2140853,4342326
840,KR,Medium,2003,45-49,1812161,1756981,3569142
840,KR,Medium,2003,05岿 09老,1292202,1276020,2568222
840,KR,Medium,2003,50-54,1047715,1057727,2105442
840,KR,Medium,2003,55-59,920359,1030288,1950647
840,KR,Medium,2003,60-64,711353,880881,1592234
840,KR,Medium,2003,65-69,425721,655781,1081502
840,KR,Medium,2003,70-74,241516,437251,678767
840,KR,Medium,2003,75-79,170466,416895,587361
840,KR,Medium,2003,80-84,119483,256483,375966
840,KR,Medium,2003,85-89,40967,117576,158543
840,KR,Medium,2003,90-94,8674,34693,43367
840,KR,Medium,2003,95-99,1205,6979,8184
840,KR,Medium,2004,0-4,1409160,1290396,2699556
840,KR,Medium,2004,10岿 14老,1752569,1568853,3321422
840,KR,Medium,2004,100+,1813909,1595626,3409535
840,KR,Medium,2004,15-19,1630004,1478831,3108835
840,KR,Medium,2004,20-24,2056353,1914220,3970573
840,KR,Medium,2004,25-29,1992129,1861144,3853273
840,KR,Medium,2004,30-34,2279293,2171339,4450632
840,KR,Medium,2004,35-39,2166489,2049533,4216022
840,KR,Medium,2004,40-44,2192667,2119774,4312441
840,KR,Medium,2004,45-49,1924199,1877912,3802111
840,KR,Medium,2004,05岿 09老,1341081,1322985,2664066
840,KR,Medium,2004,50-54,1095353,1101585,2196938
840,KR,Medium,2004,55-59,923453,1023359,1946812
840,KR,Medium,2004,60-64,740526,909221,1649747
840,KR,Medium,2004,65-69,457420,683079,1140499
840,KR,Medium,2004,70-74,252637,461135,713772
840,KR,Medium,2004,75-79,183498,442787,626285
840,KR,Medium,2004,80-84,128928,275992,404920
840,KR,Medium,2004,85-89,43798,121489,165287
840,KR,Medium,2004,90-94,9341,36684,46025
840,KR,Medium,2004,95-99,1287,7413,8700
840,KR,Medium,2005,0-4,1315045,1209243,2524288
840,KR,Medium,2005,10岿 14老,1698879,1534686,3233565
840,KR,Medium,2005,100+,1844524,1620883,3465407
840,KR,Medium,2005,15-19,1621106,1458955,3080061
840,KR,Medium,2005,20-24,1969021,1819759,3788780
840,KR,Medium,2005,25-29,1981697,1862130,3843827
840,KR,Medium,2005,30-34,2240142,2120294,4360436
840,KR,Medium,2005,35-39,2184835,2082502,4267337
840,KR,Medium,2005,40-44,2165148,2083152,4248300
840,KR,Medium,2005,45-49,2000124,1957973,3958097
840,KR,Medium,2005,05岿 09老,1436212,1425679,2861891
840,KR,Medium,2005,50-54,1136993,1148617,2285610
840,KR,Medium,2005,55-59,928692,1017483,1946175
840,KR,Medium,2005,60-64,764040,925569,1689609
840,KR,Medium,2005,65-69,494667,720174,1214841
840,KR,Medium,2005,70-74,265655,486198,751853
840,KR,Medium,2005,75-79,196454,468030,664484
840,KR,Medium,2005,80-84,137401,291845,429246
840,KR,Medium,2005,85-89,46981,126959,173940
840,KR,Medium,2005,90-94,10493,39771,50264
840,KR,Medium,2005,95-99,1411,8105,9516
840,KR,Medium,2006,0-4,1227097,1132710,2359807
840,KR,Medium,2006,10岿 14老,1641923,1494147,3136070
840,KR,Medium,2006,100+,1853437,1630271,3483708
840,KR,Medium,2006,15-19,1637309,1465976,3103285
840,KR,Medium,2006,20-24,1874314,1712887,3587201
840,KR,Medium,2006,25-29,2024586,1902550,3927136
840,KR,Medium,2006,30-34,2180616,2045655,4226271
840,KR,Medium,2006,35-39,2228330,2133591,4361921
840,KR,Medium,2006,40-44,2139138,2044892,4184030
840,KR,Medium,2006,45-49,2089417,2050067,4139484
840,KR,Medium,2006,05岿 09老,1554676,1551725,3106401
840,KR,Medium,2006,50-54,1174921,1188503,2363424
840,KR,Medium,2006,55-59,930455,1003285,1933740
840,KR,Medium,2006,60-64,788456,946202,1734658
840,KR,Medium,2006,65-69,534440,760361,1294801
840,KR,Medium,2006,70-74,281091,510663,791754
840,KR,Medium,2006,75-79,209355,495246,704601
840,KR,Medium,2006,80-84,144246,304066,448312
840,KR,Medium,2006,85-89,51536,136974,188510
840,KR,Medium,2006,90-94,11788,44238,56026
840,KR,Medium,2006,95-99,1607,8506,10113
840,KR,Medium,2007,0-4,1192170,1106072,2298242
840,KR,Medium,2007,10岿 14老,1556291,1420331,2976622
840,KR,Medium,2007,100+,1826108,1613410,3439518
840,KR,Medium,2007,15-19,1683355,1500646,3184001
840,KR,Medium,2007,20-24,1772836,1607722,3380558
840,KR,Medium,2007,25-29,2073207,1945164,4018371
840,KR,Medium,2007,30-34,2109088,1969823,4078911
840,KR,Medium,2007,35-39,2273836,2175204,4449040
840,KR,Medium,2007,40-44,2130204,2026553,4156757
840,KR,Medium,2007,45-49,2142938,2105846,4248784
840,KR,Medium,2007,05岿 09老,1648729,1638383,3287112
840,KR,Medium,2007,50-54,1212829,1228668,2441497
840,KR,Medium,2007,55-59,951179,1012370,1963549
840,KR,Medium,2007,60-64,822884,981983,1804867
840,KR,Medium,2007,65-69,571360,790845,1362205
840,KR,Medium,2007,70-74,301667,543047,844714
840,KR,Medium,2007,75-79,222509,526381,748890
840,KR,Medium,2007,80-84,150705,319301,470006
840,KR,Medium,2007,85-89,56685,147286,203971
840,KR,Medium,2007,90-94,13145,49046,62191
840,KR,Medium,2007,95-99,1784,9174,10958
840,KR,Medium,2008,0-4,1191039,1110359,2301398
840,KR,Medium,2008,10岿 14老,1468935,1340216,2809151
840,KR,Medium,2008,100+,1779836,1588438,3368274
840,KR,Medium,2008,15-19,1740377,1541647,3282024
840,KR,Medium,2008,20-24,1695754,1531096,3226850
840,KR,Medium,2008,25-29,2096715,1959552,4056267
840,KR,Medium,2008,30-34,2045263,1909544,3954807
840,KR,Medium,2008,35-39,2309682,2200297,4509979
840,KR,Medium,2008,40-44,2117845,2017430,4135275
840,KR,Medium,2008,45-49,2196142,2158522,4354664
840,KR,Medium,2008,05岿 09老,1770211,1753805,3524016
840,KR,Medium,2008,50-54,1251007,1267806,2518813
840,KR,Medium,2008,55-59,986275,1038323,2024598
840,KR,Medium,2008,60-64,855346,1011081,1866427
840,KR,Medium,2008,65-69,604560,821775,1426335
840,KR,Medium,2008,70-74,326089,571925,898014
840,KR,Medium,2008,75-79,236572,561244,797816
840,KR,Medium,2008,80-84,157822,334776,492598
840,KR,Medium,2008,85-89,61896,162581,224477
840,KR,Medium,2008,90-94,14740,52553,67293
840,KR,Medium,2008,95-99,1908,9633,11541
840,KR,Medium,2009,0-4,1174722,1098912,2273634
840,KR,Medium,2009,10岿 14老,1393600,1277896,2671496
840,KR,Medium,2009,100+,1729504,1554630,3284134
840,KR,Medium,2009,15-19,1788329,1580489,3368818
840,KR,Medium,2009,20-24,1658347,1494654,3153001
840,KR,Medium,2009,25-29,2071602,1929488,4001090
840,KR,Medium,2009,30-34,1992214,1864224,3856438
840,KR,Medium,2009,35-39,2289453,2177509,4466962
840,KR,Medium,2009,40-44,2164790,2079435,4244225
840,KR,Medium,2009,45-49,2184842,2136420,4321262
840,KR,Medium,2009,05岿 09老,1887016,1874127,3761143
840,KR,Medium,2009,50-54,1297637,1314068,2611705
840,KR,Medium,2009,55-59,1035802,1081239,2117041
840,KR,Medium,2009,60-64,861451,1008828,1870279
840,KR,Medium,2009,65-69,637772,854731,1492503
840,KR,Medium,2009,70-74,353244,600927,954171
840,KR,Medium,2009,75-79,254016,605917,859933
840,KR,Medium,2009,80-84,167548,360838,528386
840,KR,Medium,2009,85-89,67954,176849,244803
840,KR,Medium,2009,90-94,16099,55767,71866
840,KR,Medium,2009,95-99,2178,10622,12800
840,KR,Medium,2010,0-4,1172828,1098975,2271803
840,KR,Medium,2010,10岿 14老,1300568,1197359,2497927
840,KR,Medium,2010,100+,1682748,1526961,3209709
840,KR,Medium,2010,15-19,1821378,1607415,3428793
840,KR,Medium,2010,20-24,1654707,1484342,3139049
840,KR,Medium,2010,25-29,1989754,1844351,3834105
840,KR,Medium,2010,30-34,2000527,1877257,3877784
840,KR,Medium,2010,35-39,2252710,2134326,4387036
840,KR,Medium,2010,40-44,2192383,2113987,4306370
840,KR,Medium,2010,45-49,2166821,2104888,4271709
840,KR,Medium,2010,05岿 09老,1972536,1961827,3934363
840,KR,Medium,2010,50-54,1397202,1420113,2817315
840,KR,Medium,2010,55-59,1083119,1128921,2212040
840,KR,Medium,2010,60-64,871002,1007312,1878314
840,KR,Medium,2010,65-69,664268,875369,1539637
840,KR,Medium,2010,70-74,386793,638739,1025532
840,KR,Medium,2010,75-79,271770,650856,922626
840,KR,Medium,2010,80-84,178050,387547,565597
840,KR,Medium,2010,85-89,72981,188964,261945
840,KR,Medium,2010,90-94,17855,60109,77964
840,KR,Medium,2010,95-99,2615,12251,14866
840,KR,Medium,2011,0-4,1193656,1121917,2315573
840,KR,Medium,2011,10岿 14老,1214418,1121978,2336396
840,KR,Medium,2011,100+,1630159,1489332,3119491
840,KR,Medium,2011,15-19,1842937,1625599,3468536
840,KR,Medium,2011,20-24,1678222,1497451,3175673
840,KR,Medium,2011,25-29,1909497,1755305,3664802
840,KR,Medium,2011,30-34,2049481,1917946,3967427
840,KR,Medium,2011,35-39,2181088,2060239,4241327
840,KR,Medium,2011,40-44,2240870,2168151,4409021
840,KR,Medium,2011,45-49,2133627,2057463,4191090
840,KR,Medium,2011,05岿 09老,2085550,2078358,4163908
840,KR,Medium,2011,50-54,1519137,1546118,3065255
840,KR,Medium,2011,55-59,1126838,1176122,2302960
840,KR,Medium,2011,60-64,863928,982408,1846336
840,KR,Medium,2011,65-69,689761,897257,1587018
840,KR,Medium,2011,70-74,422066,679260,1101326
840,KR,Medium,2011,75-79,288632,691867,980499
840,KR,Medium,2011,80-84,189129,410686,599815
840,KR,Medium,2011,85-89,76453,198879,275332
840,KR,Medium,2011,90-94,19834,66212,86046
840,KR,Medium,2011,95-99,2917,14049,16966
840,KR,Medium,2012,0-4,1200629,1130292,2330921
840,KR,Medium,2012,10岿 14老,1180798,1096153,2276951
840,KR,Medium,2012,100+,1550478,1418881,2969359
840,KR,Medium,2012,15-19,1821485,1614091,3435576
840,KR,Medium,2012,20-24,1734689,1534260,3268949
840,KR,Medium,2012,25-29,1808875,1655989,3464864
840,KR,Medium,2012,30-34,2094985,1963703,4058688
840,KR,Medium,2012,35-39,2101052,1986641,4087693
840,KR,Medium,2012,40-44,2279295,2204694,4483989
840,KR,Medium,2012,45-49,2124531,2048855,4173386
840,KR,Medium,2012,05岿 09老,2136013,2127006,4263019
840,KR,Medium,2012,50-54,1608745,1633180,3241925
840,KR,Medium,2012,55-59,1164089,1213715,2377804
840,KR,Medium,2012,60-64,883241,991450,1874691
840,KR,Medium,2012,65-69,733285,940767,1674052
840,KR,Medium,2012,70-74,454917,712482,1167399
840,KR,Medium,2012,75-79,310273,740314,1050587
840,KR,Medium,2012,80-84,204670,438974,643644
840,KR,Medium,2012,85-89,79849,210619,290468
840,KR,Medium,2012,90-94,22157,72887,95044
840,KR,Medium,2012,95-99,3268,15652,18920
840,KR,Medium,2013,0-4,1188302,1121025,2309327
840,KR,Medium,2013,10岿 14老,1179593,1100229,2279822
840,KR,Medium,2013,100+,1464013,1339075,2803088
840,KR,Medium,2013,15-19,1779769,1593281,3373050
840,KR,Medium,2013,20-24,1794501,1576405,3370906
840,KR,Medium,2013,25-29,1734720,1580535,3315255
840,KR,Medium,2013,30-34,2111042,1975213,4086255
840,KR,Medium,2013,35-39,2028863,1920853,3949716
840,KR,Medium,2013,40-44,2305325,2222650,4527975
840,KR,Medium,2013,45-49,2089888,2035425,4125313
840,KR,Medium,2013,05岿 09老,2190098,2174567,4364665
840,KR,Medium,2013,50-54,1719950,1737360,3457310
840,KR,Medium,2013,55-59,1195750,1247802,2443552
840,KR,Medium,2013,60-64,908072,1006436,1914508
840,KR,Medium,2013,65-69,775208,979241,1754449
840,KR,Medium,2013,70-74,485151,743323,1228474
840,KR,Medium,2013,75-79,335074,790154,1125228
840,KR,Medium,2013,80-84,222240,465166,687406
840,KR,Medium,2013,85-89,83433,221824,305257
840,KR,Medium,2013,90-94,25415,84211,109626
840,KR,Medium,2013,95-99,3632,16689,20321
840,KR,Medium,2014,0-4,1179604,1115412,2295016
840,KR,Medium,2014,10岿 14老,1163582,1088920,2252502
840,KR,Medium,2014,100+,1389826,1276349,2666175
840,KR,Medium,2014,15-19,1728466,1561263,3289729
840,KR,Medium,2014,20-24,1844096,1613309,3457405
840,KR,Medium,2014,25-29,1714497,1544633,3259130
840,KR,Medium,2014,30-34,2096735,1948719,4045454
840,KR,Medium,2014,35-39,1982864,1871522,3854386
840,KR,Medium,2014,40-44,2286346,2193282,4479628
840,KR,Medium,2014,45-49,2169125,2125961,4295086
840,KR,Medium,2014,05岿 09老,2180821,2153964,4334785
840,KR,Medium,2014,50-54,1841582,1857434,3699016
840,KR,Medium,2014,55-59,1243960,1297261,2541221
840,KR,Medium,2014,60-64,958234,1047495,2005729
840,KR,Medium,2014,65-69,783053,980699,1763752
840,KR,Medium,2014,70-74,518840,779558,1298398
840,KR,Medium,2014,75-79,363446,845801,1209247
840,KR,Medium,2014,80-84,241136,491882,733018
840,KR,Medium,2014,85-89,90390,244965,335355
840,KR,Medium,2014,90-94,27414,88979,116393
840,KR,Medium,2014,95-99,4108,17537,21645
840,KR,Medium,2015,0-4,1175609,1114488,2290097
840,KR,Medium,2015,10岿 14老,1161732,1089368,2251100
840,KR,Medium,2015,100+,1294946,1193740,2488686
840,KR,Medium,2015,15-19,1684718,1537550,3222268
840,KR,Medium,2015,20-24,1877884,1634084,3511968
840,KR,Medium,2015,25-29,1730403,1539051,3269454
840,KR,Medium,2015,30-34,2015092,1856510,3871602
840,KR,Medium,2015,35-39,2004556,1887544,3892100
840,KR,Medium,2015,40-44,2248961,2149420,4398381
840,KR,Medium,2015,45-49,2199587,2154449,4354036
840,KR,Medium,2015,05岿 09老,2165419,2123620,4289039
840,KR,Medium,2015,50-54,1932408,1951809,3884217
840,KR,Medium,2015,55-59,1345931,1404900,2750831
840,KR,Medium,2015,60-64,1009632,1095999,2105631
840,KR,Medium,2015,65-69,796175,983369,1779544
840,KR,Medium,2015,70-74,546349,804154,1350503
840,KR,Medium,2015,75-79,396492,908998,1305490
840,KR,Medium,2015,80-84,266996,526920,793916
840,KR,Medium,2015,85-89,96002,267549,363551
840,KR,Medium,2015,90-94,28260,92698,120958
840,KR,Medium,2015,95-99,4790,19133,23923
840,KR,Medium,2016,0-4,1148547,1091563,2240110
840,KR,Medium,2016,10岿 14老,1183575,1113571,2297146
840,KR,Medium,2016,100+,1209141,1118166,2327307
840,KR,Medium,2016,15-19,1632747,1499457,3132204
840,KR,Medium,2016,20-24,1903218,1656631,3559849
840,KR,Medium,2016,25-29,1739228,1540583,3279811
840,KR,Medium,2016,30-34,1922760,1765495,3688255
840,KR,Medium,2016,35-39,2044466,1920219,3964685
840,KR,Medium,2016,40-44,2160777,2069252,4230029
840,KR,Medium,2016,45-49,2241597,2200173,4441770
840,KR,Medium,2016,05岿 09老,2112259,2058038,4170297
840,KR,Medium,2016,50-54,2054239,2080676,4134915
840,KR,Medium,2016,55-59,1466124,1528218,2994342
840,KR,Medium,2016,60-64,1059400,1150604,2210004
840,KR,Medium,2016,65-69,780645,948477,1729122
840,KR,Medium,2016,70-74,573514,826652,1400166
840,KR,Medium,2016,75-79,438712,979079,1417791
840,KR,Medium,2016,80-84,299295,567927,867222
840,KR,Medium,2016,85-89,104270,287025,391295
840,KR,Medium,2016,90-94,29319,99590,128909
840,KR,Medium,2016,95-99,5352,21534,26886
840,KR,Medium,2017,0-4,1102364,1048855,2151219
840,KR,Medium,2017,10岿 14老,1188607,1120380,2308987
840,KR,Medium,2017,100+,1173575,1090502,2264077
840,KR,Medium,2017,15-19,1554471,1427984,2982455
840,KR,Medium,2017,20-24,1882066,1647591,3529657
840,KR,Medium,2017,25-29,1791765,1576396,3368161
840,KR,Medium,2017,30-34,1825165,1666377,3491542
840,KR,Medium,2017,35-39,2089929,1964371,4054300
840,KR,Medium,2017,40-44,2083256,1995148,4078404
840,KR,Medium,2017,45-49,2278705,2228237,4506942
840,KR,Medium,2017,05岿 09老,2107628,2056212,4163840
840,KR,Medium,2017,50-54,2102223,2123676,4225899
840,KR,Medium,2017,55-59,1554982,1615386,3170368
840,KR,Medium,2017,60-64,1098706,1187813,2286519
840,KR,Medium,2017,65-69,800334,956466,1756800
840,KR,Medium,2017,70-74,620799,873516,1494315
840,KR,Medium,2017,75-79,482218,1046208,1528426
840,KR,Medium,2017,80-84,328523,601756,930279
840,KR,Medium,2017,85-89,115958,309209,425167
840,KR,Medium,2017,90-94,30906,107174,138080
840,KR,Medium,2017,95-99,6289,24744,31033
840,KR,Medium,2018,0-4,1041546,990466,2032012
840,KR,Medium,2018,10岿 14老,1177422,1112213,2289635
840,KR,Medium,2018,100+,1172820,1094921,2267741
840,KR,Medium,2018,15-19,1469053,1348192,2817245
840,KR,Medium,2018,20-24,1856658,1639906,3496564
840,KR,Medium,2018,25-29,1868308,1629072,3497380
840,KR,Medium,2018,30-34,1766587,1599914,3366501
840,KR,Medium,2018,35-39,2116733,1983849,4100582
840,KR,Medium,2018,40-44,2023646,1932121,3955767
840,KR,Medium,2018,45-49,2311564,2245193,4556757
840,KR,Medium,2018,05岿 09老,2076615,2046927,4123542
840,KR,Medium,2018,50-54,2163953,2175966,4339919
840,KR,Medium,2018,55-59,1669024,1721804,3390828
840,KR,Medium,2018,60-64,1133201,1225188,2358389
840,KR,Medium,2018,65-69,826425,969862,1796287
840,KR,Medium,2018,70-74,664618,915752,1580370
840,KR,Medium,2018,75-79,525329,1111785,1637114
840,KR,Medium,2018,80-84,355962,632408,988370
840,KR,Medium,2018,85-89,128560,330914,459474
840,KR,Medium,2018,90-94,32990,115467,148457
840,KR,Medium,2018,95-99,7260,29581,36841
840,KR,Medium,2019,0-4,983559,934982,1918541
840,KR,Medium,2019,10岿 14老,1168596,1106294,2274890
840,KR,Medium,2019,100+,1157292,1083904,2241196
840,KR,Medium,2019,15-19,1391741,1280927,2672668
840,KR,Medium,2019,20-24,1803239,1608817,3412056
840,KR,Medium,2019,25-29,1918741,1662127,3580868
840,KR,Medium,2019,30-34,1743509,1563439,3306948
840,KR,Medium,2019,35-39,2098941,1956500,4055441
840,KR,Medium,2019,40-44,1973968,1879423,3853391
840,KR,Medium,2019,45-49,2281831,2207395,4489226
840,KR,Medium,2019,05岿 09老,2157585,2137203,4294788
840,KR,Medium,2019,50-54,2145552,2148568,4294120
840,KR,Medium,2019,55-59,1788387,1841659,3630046
840,KR,Medium,2019,60-64,1178002,1272289,2450291
840,KR,Medium,2019,65-69,877165,1011110,1888275
840,KR,Medium,2019,70-74,671162,916514,1587676
840,KR,Medium,2019,75-79,574025,1184652,1758677
840,KR,Medium,2019,80-84,386322,667643,1053965
840,KR,Medium,2019,85-89,142392,353519,495911
840,KR,Medium,2019,90-94,37438,130257,167695
840,KR,Medium,2019,95-99,7246,29749,36995
840,KR,Medium,2020,0-4,913646,867726,1781372
840,KR,Medium,2020,10岿 14老,1166742,1107626,2274368
840,KR,Medium,2020,100+,1156254,1084844,2241098
840,KR,Medium,2020,15-19,1295123,1195879,2491002
840,KR,Medium,2020,20-24,1752129,1582407,3334536
840,KR,Medium,2020,25-29,1951603,1685646,3637249
840,KR,Medium,2020,30-34,1758425,1561193,3319618
840,KR,Medium,2020,35-39,2017000,1866932,3883932
840,KR,Medium,2020,40-44,1995884,1895119,3891003
840,KR,Medium,2020,45-49,2238898,2161827,4400725
840,KR,Medium,2020,05岿 09老,2183366,2160401,4343767
840,KR,Medium,2020,50-54,2126847,2116433,4243280
840,KR,Medium,2020,55-59,1877159,1936038,3813197
840,KR,Medium,2020,60-64,1279317,1380473,2659790
840,KR,Medium,2020,65-69,929580,1061140,1990720
840,KR,Medium,2020,70-74,683099,917714,1600813
840,KR,Medium,2020,75-79,620665,1253444,1874109
840,KR,Medium,2020,80-84,410587,691858,1102445
840,KR,Medium,2020,85-89,161308,383163,544471
840,KR,Medium,2020,90-94,40832,143803,184635
840,KR,Medium,2020,95-99,7236,30869,38105
840,KR,Medium,2021,0-4,843025,799341,1642366
840,KR,Medium,2021,10岿 14老,1139761,1084111,2223872
840,KR,Medium,2021,100+,1177163,1108289,2285452
840,KR,Medium,2021,15-19,1208485,1119089,2327574
840,KR,Medium,2021,20-24,1688988,1536816,3225804
840,KR,Medium,2021,25-29,1976260,1708217,3684477
840,KR,Medium,2021,30-34,1771640,1564467,3336107
840,KR,Medium,2021,35-39,1933438,1778423,3711861
840,KR,Medium,2021,40-44,2042064,1928884,3970948
840,KR,Medium,2021,45-49,2157304,2082473,4239777
840,KR,Medium,2021,05岿 09老,2230891,2208009,4438900
840,KR,Medium,2021,50-54,2080597,2053171,4133768
840,KR,Medium,2021,55-59,1999159,2064581,4063740
840,KR,Medium,2021,60-64,1396152,1502135,2898287
840,KR,Medium,2021,65-69,976852,1115795,2092647
840,KR,Medium,2021,70-74,672023,886458,1558481
840,KR,Medium,2021,75-79,667730,1319878,1987608
840,KR,Medium,2021,80-84,433874,713730,1147604
840,KR,Medium,2021,85-89,181442,414624,596066
840,KR,Medium,2021,90-94,44310,154441,198751
840,KR,Medium,2021,95-99,7361,33031,40392
840,KR,Medium,2022,0-4,793866,752710,1546576
840,KR,Medium,2022,10岿 14老,1094257,1041910,2136167
840,KR,Medium,2022,100+,1184896,1117187,2302083
840,KR,Medium,2022,15-19,1173769,1092193,2265962
840,KR,Medium,2022,20-24,1599102,1456668,3055770
840,KR,Medium,2022,25-29,1949093,1698056,3647149
840,KR,Medium,2022,30-34,1826921,1601454,3428375
840,KR,Medium,2022,35-39,1840625,1682139,3522764
840,KR,Medium,2022,40-44,2093362,1975953,4069315
840,KR,Medium,2022,45-49,2085108,2010755,4095863
840,KR,Medium,2022,05岿 09老,2271703,2238035,4509738
840,KR,Medium,2022,50-54,2080051,2054363,4134414
840,KR,Medium,2022,55-59,2048214,2109306,4157520
840,KR,Medium,2022,60-64,1484431,1590353,3074784
840,KR,Medium,2022,65-69,1016354,1153533,2169887
840,KR,Medium,2022,70-74,694038,897224,1591262
840,KR,Medium,2022,75-79,732051,1406659,2138710
840,KR,Medium,2022,80-84,473391,757438,1230829
840,KR,Medium,2022,85-89,200205,441034,641239
840,KR,Medium,2022,90-94,49728,167436,217164
840,KR,Medium,2022,95-99,7875,36125,44000
840,KR,Medium,2023,0-4,770347,730379,1500726
840,KR,Medium,2023,10岿 14老,1034139,984031,2018170
840,KR,Medium,2023,100+,1173176,1108748,2281924
840,KR,Medium,2023,15-19,1172049,1095419,2267468
840,KR,Medium,2023,20-24,1499977,1366600,2866577
840,KR,Medium,2023,25-29,1901127,1680830,3581957
840,KR,Medium,2023,30-34,1893074,1644622,3537696
840,KR,Medium,2023,35-39,1772841,1607196,3380037
840,KR,Medium,2023,40-44,2114237,1988488,4102725
840,KR,Medium,2023,45-49,2020746,1943668,3964414
840,KR,Medium,2023,05岿 09老,2299857,2253032,4552889
840,KR,Medium,2023,50-54,2049149,2045182,4094331
840,KR,Medium,2023,55-59,2110076,2161836,4271912
840,KR,Medium,2023,60-64,1596686,1696969,3293655
840,KR,Medium,2023,65-69,1051130,1191067,2242197
840,KR,Medium,2023,70-74,721066,912580,1633646
840,KR,Medium,2023,75-79,791931,1485845,2277776
840,KR,Medium,2023,80-84,509097,795799,1304896
840,KR,Medium,2023,85-89,217674,464548,682222
840,KR,Medium,2023,90-94,55586,180166,235752
840,KR,Medium,2023,95-99,8587,39741,48328
840,KR,Medium,2024,0-4,763917,724257,1488174
840,KR,Medium,2024,10岿 14老,976939,929244,1906183
840,KR,Medium,2024,100+,1164315,1102739,2267054
840,KR,Medium,2024,15-19,1155835,1083594,2239429
840,KR,Medium,2024,20-24,1415336,1295979,2711315
840,KR,Medium,2024,25-29,1839752,1648134,3487886
840,KR,Medium,2024,30-34,1941008,1678039,3619047
840,KR,Medium,2024,35-39,1749294,1571104,3320398
840,KR,Medium,2024,40-44,2096884,1961098,4057982
840,KR,Medium,2024,45-49,1971513,1890622,3862135
840,KR,Medium,2024,05岿 09老,2270944,2215733,4486677
840,KR,Medium,2024,50-54,2130028,2136012,4266040
840,KR,Medium,2024,55-59,2094521,2136080,4230601
840,KR,Medium,2024,60-64,1713880,1816402,3530282
840,KR,Medium,2024,65-69,1095557,1238089,2333646
840,KR,Medium,2024,70-74,767865,952975,1720840
840,KR,Medium,2024,75-79,826002,1533932,2359934
840,KR,Medium,2024,80-84,515186,797438,1312624
840,KR,Medium,2024,85-89,237658,492177,729835
840,KR,Medium,2024,90-94,62288,193794,256082
840,KR,Medium,2024,95-99,9895,45027,54922
840,KR,Medium,2025,0-4,771935,731837,1503772
840,KR,Medium,2025,10岿 14老,907764,862651,1770415
840,KR,Medium,2025,100+,1162421,1103983,2266404
840,KR,Medium,2025,15-19,1154168,1083877,2238045
840,KR,Medium,2025,20-24,1312816,1207928,2520744
840,KR,Medium,2025,25-29,1781587,1619874,3401461
840,KR,Medium,2025,30-34,1971612,1701767,3673379
840,KR,Medium,2025,35-39,1763739,1569010,3332749
840,KR,Medium,2025,40-44,2015576,1871676,3887252
840,KR,Medium,2025,45-49,1993418,1905808,3899226
840,KR,Medium,2025,05岿 09老,2228682,2170459,4399141
840,KR,Medium,2025,50-54,2156972,2160190,4317162
840,KR,Medium,2025,55-59,2078682,2105534,4184216
840,KR,Medium,2025,60-64,1802584,1911117,3713701
840,KR,Medium,2025,65-69,1193444,1344969,2538413
840,KR,Medium,2025,70-74,816218,1001561,1817779
840,KR,Medium,2025,75-79,862665,1578602,2441267
840,KR,Medium,2025,80-84,525703,799400,1325103
840,KR,Medium,2025,85-89,254009,512045,766054
840,KR,Medium,2025,90-94,71168,211656,282824
840,KR,Medium,2025,95-99,10809,49792,60601
840,KR,Medium,2026,0-4,793966,752709,1546675
840,KR,Medium,2026,10岿 14老,837862,794919,1632781
840,KR,Medium,2026,100+,1135423,1080409,2215832
840,KR,Medium,2026,15-19,1174485,1106662,2281147
840,KR,Medium,2026,20-24,1221399,1128358,2349757
840,KR,Medium,2026,25-29,1712141,1572547,3284688
840,KR,Medium,2026,30-34,1994244,1724396,3718640
840,KR,Medium,2026,35-39,1776575,1572324,3348899
840,KR,Medium,2026,40-44,1932538,1783242,3715780
840,KR,Medium,2026,45-49,2039546,1939154,3978700
840,KR,Medium,2026,05岿 09老,2148181,2091427,4239608
840,KR,Medium,2026,50-54,2205104,2208395,4413499
840,KR,Medium,2026,55-59,2036051,2044042,4080093
840,KR,Medium,2026,60-64,1922947,2039325,3962272
840,KR,Medium,2026,65-69,1304810,1464369,2769179
840,KR,Medium,2026,70-74,857758,1052657,1910415
840,KR,Medium,2026,75-79,880774,1591723,2472497
840,KR,Medium,2026,80-84,517664,771987,1289651
840,KR,Medium,2026,85-89,269926,530188,800114
840,KR,Medium,2026,90-94,80442,229935,310377
840,KR,Medium,2026,95-99,11742,53440,65182
840,KR,Medium,2027,0-4,822689,779926,1602615
840,KR,Medium,2027,10岿 14老,789250,748780,1538030
840,KR,Medium,2027,100+,1090022,1038274,2128296
840,KR,Medium,2027,15-19,1181681,1114884,2296565
840,KR,Medium,2027,20-24,1182297,1098573,2280870
840,KR,Medium,2027,25-29,1617063,1490800,3107863
840,KR,Medium,2027,30-34,1965281,1714217,3679498
840,KR,Medium,2027,35-39,1831443,1609204,3440647
840,KR,Medium,2027,40-44,1840241,1686983,3527224
840,KR,Medium,2027,45-49,2090810,1985849,4076659
840,KR,Medium,2027,05岿 09老,2076862,2019859,4096721
840,KR,Medium,2027,50-54,2246537,2238999,4485536
840,KR,Medium,2027,55-59,2037434,2046142,4083576
840,KR,Medium,2027,60-64,1972882,2084619,4057501
840,KR,Medium,2027,65-69,1390409,1551623,2942032
840,KR,Medium,2027,70-74,896068,1090270,1986338
840,KR,Medium,2027,75-79,941026,1662218,2603244
840,KR,Medium,2027,80-84,540070,785678,1325748
840,KR,Medium,2027,85-89,297245,565891,863136
840,KR,Medium,2027,90-94,89265,245464,334729
840,KR,Medium,2027,95-99,13347,58293,71640
840,KR,Medium,2028,0-4,850775,806544,1657319
840,KR,Medium,2028,10岿 14老,765996,726677,1492673
840,KR,Medium,2028,100+,1030140,980585,2010725
840,KR,Medium,2028,15-19,1169555,1105896,2275451
840,KR,Medium,2028,20-24,1176580,1098742,2275322
840,KR,Medium,2028,25-29,1513799,1398746,2912545
840,KR,Medium,2028,30-34,1915648,1696880,3612528
840,KR,Medium,2028,35-39,1897247,1652168,3549415
840,KR,Medium,2028,40-44,1772807,1611951,3384758
840,KR,Medium,2028,45-49,2111815,1998155,4109970
840,KR,Medium,2028,05岿 09老,2013340,1952899,3966239
840,KR,Medium,2028,50-54,2275441,2254549,4529990
840,KR,Medium,2028,55-59,2009459,2038025,4047484
840,KR,Medium,2028,60-64,2035312,2137558,4172870
840,KR,Medium,2028,65-69,1498388,1656714,3155102
840,KR,Medium,2028,70-74,930166,1127589,2057755
840,KR,Medium,2028,75-79,1001651,1730149,2731800
840,KR,Medium,2028,80-84,566420,803433,1369853
840,KR,Medium,2028,85-89,321506,596594,918100
840,KR,Medium,2028,90-94,97424,259193,356617
840,KR,Medium,2028,95-99,15072,63147,78219
840,KR,Medium,2029,0-4,875313,829799,1705112
840,KR,Medium,2029,10岿 14老,759592,720562,1480154
840,KR,Medium,2029,100+,973195,926008,1899203
840,KR,Medium,2029,15-19,1160341,1099511,2259852
840,KR,Medium,2029,20-24,1157008,1083746,2240754
840,KR,Medium,2029,25-29,1425487,1325837,2751324
840,KR,Medium,2029,30-34,1852714,1663884,3516598
840,KR,Medium,2029,35-39,1944877,1685262,3630139
840,KR,Medium,2029,40-44,1749423,1575591,3325014
840,KR,Medium,2029,45-49,2094674,1970519,4065193
840,KR,Medium,2029,05岿 09老,1964777,1899849,3864626
840,KR,Medium,2029,50-54,2248195,2217930,4466125
840,KR,Medium,2029,55-59,2090236,2128928,4219164
840,KR,Medium,2029,60-64,2022705,2113052,4135757
840,KR,Medium,2029,65-69,1610854,1774266,3385120
840,KR,Medium,2029,70-74,972590,1173767,2146357
840,KR,Medium,2029,75-79,1057163,1792943,2850106
840,KR,Medium,2029,80-84,605909,841479,1447388
840,KR,Medium,2029,85-89,325669,598326,923995
840,KR,Medium,2029,90-94,107068,275908,382976
840,KR,Medium,2029,95-99,17091,68460,85551
840,KR,Medium,2030,0-4,893586,847115,1740701
840,KR,Medium,2030,10岿 14老,767486,728010,1495496
840,KR,Medium,2030,100+,904270,859623,1763893
840,KR,Medium,2030,15-19,1158161,1100419,2258580
840,KR,Medium,2030,20-24,1152223,1081440,2233663
840,KR,Medium,2030,25-29,1319520,1236030,2555550
840,KR,Medium,2030,30-34,1793221,1635351,3428572
840,KR,Medium,2030,35-39,1975243,1708689,3683932
840,KR,Medium,2030,40-44,1763968,1573216,3337184
840,KR,Medium,2030,45-49,2013926,1880983,3894909
840,KR,Medium,2030,05岿 09老,1986802,1914927,3901729
840,KR,Medium,2030,50-54,2207500,2173217,4380717
840,KR,Medium,2030,55-59,2118655,2153799,4272454
840,KR,Medium,2030,60-64,2010216,2083994,4094210
840,KR,Medium,2030,65-69,1697940,1868477,3566417
840,KR,Medium,2030,70-74,1064249,1277765,2342014
840,KR,Medium,2030,75-79,1116349,1860583,2976932
840,KR,Medium,2030,80-84,646765,886581,1533346
840,KR,Medium,2030,85-89,333208,600385,933593
840,KR,Medium,2030,90-94,115122,288480,403602
840,KR,Medium,2030,95-99,19703,75459,95162
840,KR,Medium,2031,0-4,904815,857752,1762567
840,KR,Medium,2031,10岿 14老,789269,748639,1537908
840,KR,Medium,2031,100+,834631,792115,1626746
840,KR,Medium,2031,15-19,1131129,1076680,2207809
840,KR,Medium,2031,20-24,1170067,1102323,2272390
840,KR,Medium,2031,25-29,1225096,1155008,2380104
840,KR,Medium,2031,30-34,1722693,1587751,3310444
840,KR,Medium,2031,35-39,1997687,1731045,3728732
840,KR,Medium,2031,40-44,1776963,1576305,3353268
840,KR,Medium,2031,45-49,1931395,1792339,3723734
840,KR,Medium,2031,05岿 09老,2033034,1948248,3981282
840,KR,Medium,2031,50-54,2129083,2094791,4223874
840,KR,Medium,2031,55-59,2167664,2202356,4370020
840,KR,Medium,2031,60-64,1972096,2024446,3996542
840,KR,Medium,2031,65-69,1814656,1995215,3809871
840,KR,Medium,2031,70-74,1165851,1392171,2558022
840,KR,Medium,2031,75-79,1154398,1902185,3056583
840,KR,Medium,2031,80-84,679065,930594,1609659
840,KR,Medium,2031,85-89,328179,578834,907013
840,KR,Medium,2031,90-94,123099,300079,423178
840,KR,Medium,2031,95-99,22374,82299,104673
840,KR,Medium,2032,0-4,908595,861331,1769926
840,KR,Medium,2032,10岿 14老,817667,775544,1593211
840,KR,Medium,2032,100+,786236,746159,1532395
840,KR,Medium,2032,15-19,1085835,1034622,2120457
840,KR,Medium,2032,20-24,1175862,1109099,2284961
840,KR,Medium,2032,25-29,1183677,1124033,2307710
840,KR,Medium,2032,30-34,1626616,1505804,3132420
840,KR,Medium,2032,35-39,1968687,1720728,3689415
840,KR,Medium,2032,40-44,1831873,1612944,3444817
840,KR,Medium,2032,45-49,1839682,1695932,3535614
840,KR,Medium,2032,05岿 09老,2084454,1994944,4079398
840,KR,Medium,2032,50-54,2059531,2023680,4083211
840,KR,Medium,2032,55-59,2209972,2233384,4443356
840,KR,Medium,2032,60-64,1975746,2027375,4003121
840,KR,Medium,2032,65-69,1864252,2040511,3904763
840,KR,Medium,2032,70-74,1245841,1476979,2722820
840,KR,Medium,2032,75-79,1225519,1985024,3210543
840,KR,Medium,2032,80-84,713801,967223,1681024
840,KR,Medium,2032,85-89,347650,595244,942894
840,KR,Medium,2032,90-94,137175,322997,460172
840,KR,Medium,2032,95-99,24953,88137,113090
840,KR,Medium,2033,0-4,904841,857769,1762610
840,KR,Medium,2033,10岿 14老,845425,801846,1647271
840,KR,Medium,2033,100+,763091,724146,1487237
840,KR,Medium,2033,15-19,1026174,977127,2003301
840,KR,Medium,2033,20-24,1163279,1099277,2262556
840,KR,Medium,2033,25-29,1176304,1123527,2299831
840,KR,Medium,2033,30-34,1522541,1413628,2936169
840,KR,Medium,2033,35-39,1919069,1703340,3622409
840,KR,Medium,2033,40-44,1897756,1655724,3553480
840,KR,Medium,2033,45-49,1772705,1620762,3393467
840,KR,Medium,2033,05岿 09老,2105867,2007384,4113251
840,KR,Medium,2033,50-54,1997688,1957177,3954865
840,KR,Medium,2033,55-59,2239924,2249411,4489335
840,KR,Medium,2033,60-64,1951358,2020376,3971734
840,KR,Medium,2033,65-69,1926203,2093400,4019603
840,KR,Medium,2033,70-74,1345657,1578508,2924165
840,KR,Medium,2033,75-79,1293261,2065585,3358846
840,KR,Medium,2033,80-84,745002,1003343,1748345
840,KR,Medium,2033,85-89,369460,614541,984001
840,KR,Medium,2033,90-94,149278,341973,491251
840,KR,Medium,2033,95-99,27310,93237,120547
840,KR,Medium,2034,0-4,895509,848917,1744426
840,KR,Medium,2034,10岿 14老,869723,824874,1694597
840,KR,Medium,2034,100+,756712,718052,1474764
840,KR,Medium,2034,15-19,969508,922836,1892344
840,KR,Medium,2034,20-24,1153879,1092605,2246484
840,KR,Medium,2034,25-29,1155863,1108628,2264491
840,KR,Medium,2034,30-34,1433800,1340801,2774601
840,KR,Medium,2034,35-39,1856253,1670480,3526733
840,KR,Medium,2034,40-44,1945579,1688833,3634412
840,KR,Medium,2034,45-49,1749671,1584393,3334064
840,KR,Medium,2034,05岿 09老,2089414,1979992,4069406
840,KR,Medium,2034,50-54,1950699,1904628,3855327
840,KR,Medium,2034,55-59,2214985,2213673,4428658
840,KR,Medium,2034,60-64,2031913,2111144,4143057
840,KR,Medium,2034,65-69,1916445,2070207,3986652
840,KR,Medium,2034,70-74,1449149,1691687,3140836
840,KR,Medium,2034,75-79,1363724,2149831,3513555
840,KR,Medium,2034,80-84,782638,1047072,1829710
840,KR,Medium,2034,85-89,397359,646568,1043927
840,KR,Medium,2034,90-94,150957,342702,493659
840,KR,Medium,2034,95-99,30232,99813,130045
840,KR,Medium,2035,0-4,882816,836882,1719698
840,KR,Medium,2035,10岿 14老,887809,842012,1729821
840,KR,Medium,2035,100+,764562,725461,1490023
840,KR,Medium,2035,15-19,900913,856701,1757614
840,KR,Medium,2035,20-24,1151483,1093768,2245251
840,KR,Medium,2035,25-29,1151153,1106368,2257521
840,KR,Medium,2035,30-34,1327677,1251063,2578740
840,KR,Medium,2035,35-39,1796916,1642047,3438963
840,KR,Medium,2035,40-44,1976166,1712324,3688490
840,KR,Medium,2035,45-49,1764465,1582064,3346529
840,KR,Medium,2035,05岿 09老,2009786,1890743,3900529
840,KR,Medium,2035,50-54,1973433,1919931,3893364
840,KR,Medium,2035,55-59,2176416,2169661,4346077
840,KR,Medium,2035,60-64,2061907,2136669,4198576
840,KR,Medium,2035,65-69,1907639,2043117,3950756
840,KR,Medium,2035,70-74,1532252,1784417,3316669
840,KR,Medium,2035,75-79,1478982,2292292,3771274
840,KR,Medium,2035,80-84,862444,1144488,2006932
840,KR,Medium,2035,85-89,426197,683718,1109915
840,KR,Medium,2035,90-94,154717,343959,498676
840,KR,Medium,2035,95-99,32678,104911,137589
840,KR,Medium,2036,0-4,867435,822300,1689735
840,KR,Medium,2036,10岿 14老,898932,852550,1751482
840,KR,Medium,2036,100+,786255,746006,1532261
840,KR,Medium,2036,15-19,831611,789509,1621120
840,KR,Medium,2036,20-24,1124502,1070455,2194957
840,KR,Medium,2036,25-29,1169169,1127081,2296250
840,KR,Medium,2036,30-34,1233095,1170162,2403257
840,KR,Medium,2036,35-39,1726558,1594631,3321189
840,KR,Medium,2036,40-44,1998830,1734782,3733612
840,KR,Medium,2036,45-49,1777797,1585276,3363073
840,KR,Medium,2036,05岿 09老,1928258,1802290,3730548
840,KR,Medium,2036,50-54,2020190,1953516,3973706
840,KR,Medium,2036,55-59,2100757,2092133,4192890
840,KR,Medium,2036,60-64,2111795,2185550,4297345
840,KR,Medium,2036,65-69,1875003,1986394,3861397
840,KR,Medium,2036,70-74,1641657,1907704,3549361
840,KR,Medium,2036,75-79,1583698,2419816,4003514
840,KR,Medium,2036,80-84,947073,1248261,2195334
840,KR,Medium,2036,85-89,446072,715060,1161132
840,KR,Medium,2036,90-94,152068,330229,482297
840,KR,Medium,2036,95-99,35135,109635,144770
840,KR,Medium,2037,0-4,850177,805937,1656114
840,KR,Medium,2037,10岿 14老,902679,856095,1758774
840,KR,Medium,2037,100+,814526,772797,1587323
840,KR,Medium,2037,15-19,783488,743882,1527370
840,KR,Medium,2037,20-24,1079523,1028903,2108426
840,KR,Medium,2037,25-29,1174980,1133962,2308942
840,KR,Medium,2037,30-34,1191601,1139262,2330863
840,KR,Medium,2037,35-39,1630623,1512926,3143549
840,KR,Medium,2037,40-44,1970164,1724623,3694787
840,KR,Medium,2037,45-49,1832891,1622001,3454892
840,KR,Medium,2037,05岿 09老,1837581,1706098,3543679
840,KR,Medium,2037,50-54,2072083,2000435,4072518
840,KR,Medium,2037,55-59,2033603,2021770,4055373
840,KR,Medium,2037,60-64,2154938,2216975,4371913
840,KR,Medium,2037,65-69,1881079,1990339,3871418
840,KR,Medium,2037,70-74,1688845,1951889,3640734
840,KR,Medium,2037,75-79,1697364,2557285,4254649
840,KR,Medium,2037,80-84,1016175,1327018,2343193
840,KR,Medium,2037,85-89,473048,747634,1220682
840,KR,Medium,2037,90-94,164674,345444,510118
840,KR,Medium,2037,95-99,39711,119309,159020
840,KR,Medium,2038,0-4,831922,788629,1620551
840,KR,Medium,2038,10岿 14老,898960,852564,1751524
840,KR,Medium,2038,100+,842149,798975,1641124
840,KR,Medium,2038,15-19,760513,722092,1482605
840,KR,Medium,2038,20-24,1020106,972310,1992416
840,KR,Medium,2038,25-29,1162304,1124344,2286648
840,KR,Medium,2038,30-34,1184302,1138797,2323099
840,KR,Medium,2038,35-39,1526646,1421001,2947647
840,KR,Medium,2038,40-44,1920836,1707379,3628215
840,KR,Medium,2038,45-49,1898989,1664923,3563912
840,KR,Medium,2038,05岿 09老,1771386,1631077,3402463
840,KR,Medium,2038,50-54,2094208,2013194,4107402
840,KR,Medium,2038,55-59,1974000,1956001,3930001
840,KR,Medium,2038,60-64,2185931,2233529,4419460
840,KR,Medium,2038,65-69,1861188,1984925,3846113
840,KR,Medium,2038,70-74,1748404,2003746,3752150
840,KR,Medium,2038,75-79,1823988,2707164,4531152
840,KR,Medium,2038,80-84,1101070,1420282,2521352
840,KR,Medium,2038,85-89,497353,779328,1276681
840,KR,Medium,2038,90-94,177993,361740,539733
840,KR,Medium,2038,95-99,43447,126838,170285
840,KR,Medium,2039,0-4,813549,771210,1584759
840,KR,Medium,2039,10岿 14老,889719,843796,1733515
840,KR,Medium,2039,100+,866328,821896,1688224
840,KR,Medium,2039,15-19,754209,716103,1470312
840,KR,Medium,2039,20-24,963554,919195,1882749
840,KR,Medium,2039,25-29,1153078,1117740,2270818
840,KR,Medium,2039,30-34,1163901,1123946,2287847
840,KR,Medium,2039,35-39,1437973,1348401,2786374
840,KR,Medium,2039,40-44,1858285,1674700,3532985
840,KR,Medium,2039,45-49,1947103,1698213,3645316
840,KR,Medium,2039,05岿 09老,1748866,1594823,3343689
840,KR,Medium,2039,50-54,2078690,1986158,4064848
840,KR,Medium,2039,55-59,1928970,1904111,3833081
840,KR,Medium,2039,60-64,2163714,2198903,4362617
840,KR,Medium,2039,65-69,1940709,2075160,4015869
840,KR,Medium,2039,70-74,1741331,1982138,3723469
840,KR,Medium,2039,75-79,1954603,2869978,4824581
840,KR,Medium,2039,80-84,1188310,1523626,2711936
840,KR,Medium,2039,85-89,525615,816510,1342125
840,KR,Medium,2039,90-94,192424,382785,575209
840,KR,Medium,2039,95-99,43646,126578,170224
840,KR,Medium,2040,0-4,795856,754434,1550290
840,KR,Medium,2040,10岿 14老,877158,831883,1709041
840,KR,Medium,2040,100+,884326,838957,1723283
840,KR,Medium,2040,15-19,762058,723546,1485604
840,KR,Medium,2040,20-24,895270,854345,1749615
840,KR,Medium,2040,25-29,1151077,1118703,2269780
840,KR,Medium,2040,30-34,1159166,1121730,2280896
840,KR,Medium,2040,35-39,1331951,1258940,2590891
840,KR,Medium,2040,40-44,1799174,1646448,3445622
840,KR,Medium,2040,45-49,1978007,1721903,3699910
840,KR,Medium,2040,05岿 09老,1764018,1592621,3356639
840,KR,Medium,2040,50-54,2000570,1897386,3897956
840,KR,Medium,2040,55-59,1952578,1919734,3872312
840,KR,Medium,2040,60-64,2127779,2155835,4283614
840,KR,Medium,2040,65-69,1972217,2101425,4073642
840,KR,Medium,2040,70-74,1737155,1958322,3695477
840,KR,Medium,2040,75-79,2104798,3066006,5170804
840,KR,Medium,2040,80-84,1262460,1611880,2874340
840,KR,Medium,2040,85-89,585209,898966,1484175
840,KR,Medium,2040,90-94,207341,406520,613861
840,KR,Medium,2040,95-99,44774,126927,171701
840,KR,Medium,2041,0-4,779481,738907,1518388
840,KR,Medium,2041,10岿 14老,861936,817444,1679380
840,KR,Medium,2041,100+,895403,849453,1744856
840,KR,Medium,2041,15-19,783685,744071,1527756
840,KR,Medium,2041,20-24,826579,788270,1614849
840,KR,Medium,2041,25-29,1124308,1095226,2219534
840,KR,Medium,2041,30-34,1177281,1142469,2319750
840,KR,Medium,2041,35-39,1237436,1178306,2415742
840,KR,Medium,2041,40-44,1729049,1599228,3328277
840,KR,Medium,2041,45-49,2000970,1744542,3745512
840,KR,Medium,2041,05岿 09老,1777811,1596016,3373827
840,KR,Medium,2041,50-54,1920437,1809311,3729748
840,KR,Medium,2041,55-59,1999949,1953604,3953553
840,KR,Medium,2041,60-64,2055701,2079537,4135238
840,KR,Medium,2041,65-69,2022784,2150529,4173313
840,KR,Medium,2041,70-74,1712432,1906764,3619196
840,KR,Medium,2041,75-79,2266945,3274018,5540963
840,KR,Medium,2041,80-84,1357678,1726683,3084361
840,KR,Medium,2041,85-89,644374,981437,1625811
840,KR,Medium,2041,90-94,215635,422094,637729
840,KR,Medium,2041,95-99,43827,120953,164780
840,KR,Medium,2042,0-4,764817,725005,1489822
840,KR,Medium,2042,10岿 14老,844857,801241,1646098
840,KR,Medium,2042,100+,899140,852988,1752128
840,KR,Medium,2042,15-19,811850,770777,1582627
840,KR,Medium,2042,20-24,779033,743450,1522483
840,KR,Medium,2042,25-29,1079528,1053579,2133107
840,KR,Medium,2042,30-34,1183212,1149372,2332584
840,KR,Medium,2042,35-39,1195968,1147573,2343541
840,KR,Medium,2042,40-44,1633345,1517772,3151117
840,KR,Medium,2042,45-49,1972743,1734572,3707315
840,KR,Medium,2042,05岿 09老,1833156,1632910,3466066
840,KR,Medium,2042,50-54,1831210,1713517,3544727
840,KR,Medium,2042,55-59,2052384,2000748,4053132
840,KR,Medium,2042,60-64,1991756,2010260,4002016
840,KR,Medium,2042,65-69,2066462,2182305,4248767
840,KR,Medium,2042,70-74,1721373,1912288,3633661
840,KR,Medium,2042,75-79,2380717,3414785,5795502
840,KR,Medium,2042,80-84,1398932,1767504,3166436
840,KR,Medium,2042,85-89,695085,1046599,1741684
840,KR,Medium,2042,90-94,231520,445553,677073
840,KR,Medium,2042,95-99,48945,129959,178904
840,KR,Medium,2043,0-4,751942,712799,1464741
840,KR,Medium,2043,10岿 14老,826790,784104,1610894
840,KR,Medium,2043,100+,895441,849475,1744916
840,KR,Medium,2043,15-19,839357,796838,1636195
840,KR,Medium,2043,20-24,756453,722127,1478580
840,KR,Medium,2043,25-29,1020523,996637,2017160
840,KR,Medium,2043,30-34,1170584,1139800,2310384
840,KR,Medium,2043,35-39,1188728,1147209,2335937
840,KR,Medium,2043,40-44,1529562,1426120,2955682
840,KR,Medium,2043,45-49,1923797,1717455,3641252
840,KR,Medium,2043,05岿 09老,1899538,1676060,3575598
840,KR,Medium,2043,50-54,1766141,1638809,3404950
840,KR,Medium,2043,55-59,2075383,2013877,4089260
840,KR,Medium,2043,60-64,1935219,1945591,3880810
840,KR,Medium,2043,65-69,2098390,2199496,4297886
840,KR,Medium,2043,70-74,1708087,1909693,3617780
840,KR,Medium,2043,75-79,2515366,3571943,6087309
840,KR,Medium,2043,80-84,1452552,1816182,3268734
840,KR,Medium,2043,85-89,756316,1122439,1878755
840,KR,Medium,2043,90-94,245704,467810,713514
840,KR,Medium,2043,95-99,53944,138656,192600
840,KR,Medium,2044,0-4,740587,702035,1442622
840,KR,Medium,2044,10岿 14老,808608,766859,1575467
840,KR,Medium,2044,100+,886247,840749,1726996
840,KR,Medium,2044,15-19,863433,819647,1683080
840,KR,Medium,2044,20-24,750451,716260,1466711
840,KR,Medium,2044,25-29,964499,942907,1907406
840,KR,Medium,2044,30-34,1161321,1133235,2294556
840,KR,Medium,2044,35-39,1168418,1132453,2300871
840,KR,Medium,2044,40-44,1441030,1353736,2794766
840,KR,Medium,2044,45-49,1861589,1684900,3546489
840,KR,Medium,2044,05岿 09老,1948044,1709584,3657628
840,KR,Medium,2044,50-54,1744370,1602770,3347140
840,KR,Medium,2044,55-59,2061071,1987275,4048346
840,KR,Medium,2044,60-64,1892945,1894701,3787646
840,KR,Medium,2044,65-69,2079772,2166522,4246294
840,KR,Medium,2044,70-74,1785049,1998315,3783364
840,KR,Medium,2044,75-79,2593776,3669484,6263260
840,KR,Medium,2044,80-84,1448303,1796747,3245050
840,KR,Medium,2044,85-89,818491,1205580,2024071
840,KR,Medium,2044,90-94,261594,492830,754424
840,KR,Medium,2044,95-99,58549,147574,206123
840,KR,Medium,2045,0-4,730197,692183,1422380
840,KR,Medium,2045,10岿 14老,791098,750254,1541352
840,KR,Medium,2045,100+,873753,828896,1702649
840,KR,Medium,2045,15-19,881346,836613,1717959
840,KR,Medium,2045,20-24,758521,723531,1482052
840,KR,Medium,2045,25-29,896536,877455,1773991
840,KR,Medium,2045,30-34,1159320,1134223,2293543
840,KR,Medium,2045,35-39,1163727,1130282,2294009
840,KR,Medium,2045,40-44,1335173,1264484,2599657
840,KR,Medium,2045,45-49,1802769,1656735,3459504
840,KR,Medium,2045,05岿 09老,1979364,1733478,3712842
840,KR,Medium,2045,50-54,1760018,1600730,3360748
840,KR,Medium,2045,55-59,1984880,1899120,3884000
840,KR,Medium,2045,60-64,1917809,1910794,3828603
840,KR,Medium,2045,65-69,2047293,2124838,4172131
840,KR,Medium,2045,70-74,1818030,2025463,3843493
840,KR,Medium,2045,75-79,2691419,3793706,6485125
840,KR,Medium,2045,80-84,1449895,1778583,3228478
840,KR,Medium,2045,85-89,875665,1282046,2157711
840,KR,Medium,2045,90-94,295472,548825,844297
840,KR,Medium,2045,95-99,63338,157339,220677
840,KR,Medium,2046,0-4,720014,682528,1402542
840,KR,Medium,2046,10岿 14老,774892,734884,1509776
840,KR,Medium,2046,100+,858613,814530,1673143
840,KR,Medium,2046,15-19,892368,847039,1739407
840,KR,Medium,2046,20-24,780199,743687,1523886
840,KR,Medium,2046,25-29,827854,810935,1638789
840,KR,Medium,2046,30-34,1132558,1110788,2243346
840,KR,Medium,2046,35-39,1181898,1151021,2332919
840,KR,Medium,2046,40-44,1240762,1184003,2424765
840,KR,Medium,2046,45-49,1732938,1609604,3342542
840,KR,Medium,2046,05岿 09老,2002712,1756292,3759004
840,KR,Medium,2046,50-54,1774404,1604329,3378733
840,KR,Medium,2046,55-59,1906540,1811571,3718111
840,KR,Medium,2046,60-64,1965913,1945004,3910917
840,KR,Medium,2046,65-69,1980161,2050489,4030650
840,KR,Medium,2046,70-74,1868649,2074399,3943048
840,KR,Medium,2046,75-79,2780983,3900929,6681912
840,KR,Medium,2046,80-84,1436064,1736518,3172582
840,KR,Medium,2046,85-89,946627,1377744,2324371
840,KR,Medium,2046,90-94,326154,599497,925651
840,KR,Medium,2046,95-99,65235,161548,226783
840,KR,Medium,2047,0-4,709223,672295,1381518
840,KR,Medium,2047,10岿 14老,760379,721125,1481504
840,KR,Medium,2047,100+,841623,798409,1640032
840,KR,Medium,2047,15-19,896083,850534,1746617
840,KR,Medium,2047,20-24,808257,769948,1578205
840,KR,Medium,2047,25-29,780196,765779,1545975
840,KR,Medium,2047,30-34,1087657,1069189,2156846
840,KR,Medium,2047,35-39,1187918,1157956,2345874
840,KR,Medium,2047,40-44,1199320,1153331,2352651
840,KR,Medium,2047,45-49,1637500,1528209,3165709
840,KR,Medium,2047,05岿 09老,1975070,1746530,3721600
840,KR,Medium,2047,50-54,1830034,1641375,3471409
840,KR,Medium,2047,55-59,1819158,1716329,3535487
840,KR,Medium,2047,60-64,2018873,1992343,4011216
840,KR,Medium,2047,65-69,1920674,1982929,3903603
840,KR,Medium,2047,70-74,1911901,2106059,4017960
840,KR,Medium,2047,75-79,2857483,3996950,6854433
840,KR,Medium,2047,80-84,1447795,1744088,3191883
840,KR,Medium,2047,85-89,976491,1409675,2386166
840,KR,Medium,2047,90-94,353956,641687,995643
840,KR,Medium,2047,95-99,71221,172931,244152
840,KR,Medium,2048,0-4,697095,660795,1357890
840,KR,Medium,2048,10岿 14老,747639,709044,1456683
840,KR,Medium,2048,100+,823649,781356,1605005
840,KR,Medium,2048,15-19,892396,847010,1739406
840,KR,Medium,2048,20-24,835607,795571,1631178
840,KR,Medium,2048,25-29,757455,744243,1501698
840,KR,Medium,2048,30-34,1028443,1012302,2040745
840,KR,Medium,2048,35-39,1175370,1148447,2323817
840,KR,Medium,2048,40-44,1192131,1152985,2345116
840,KR,Medium,2048,45-49,1533929,1436554,2970483
840,KR,Medium,2048,05岿 09老,1926640,1729549,3656189
840,KR,Medium,2048,50-54,1896700,1684702,3581402
840,KR,Medium,2048,55-59,1755527,1642050,3397577
840,KR,Medium,2048,60-64,2042741,2005832,4048573
840,KR,Medium,2048,65-69,1868392,1920065,3788457
840,KR,Medium,2048,70-74,1943878,2123802,4067680
840,KR,Medium,2048,75-79,2933163,4099691,7032854
840,KR,Medium,2048,80-84,1443169,1746107,3189276
840,KR,Medium,2048,85-89,1017707,1449732,2467439
840,KR,Medium,2048,90-94,386911,689651,1076562
840,KR,Medium,2048,95-99,76382,183181,259563
840,KR,Medium,2049,0-4,683124,647551,1330675
840,KR,Medium,2049,10岿 14老,736405,698390,1434795
840,KR,Medium,2049,100+,805562,764195,1569757
840,KR,Medium,2049,15-19,883242,838308,1721550
840,KR,Medium,2049,20-24,859522,817978,1677500
840,KR,Medium,2049,25-29,751215,738352,1489567
840,KR,Medium,2049,30-34,972208,958612,1930820
840,KR,Medium,2049,35-39,1166149,1141915,2308064
840,KR,Medium,2049,40-44,1171921,1138270,2310191
840,KR,Medium,2049,45-49,1445541,1364112,2809653
840,KR,Medium,2049,05岿 09老,1864907,1697095,3562002
840,KR,Medium,2049,50-54,1945631,1718410,3664041
840,KR,Medium,2049,55-59,1734705,1606298,3341003
840,KR,Medium,2049,60-64,2029748,1979712,4009460
840,KR,Medium,2049,65-69,1830000,1870865,3700865
840,KR,Medium,2049,70-74,1930134,2093836,4023970
840,KR,Medium,2049,75-79,3040063,4231887,7271950
840,KR,Medium,2049,80-84,1513436,1830214,3343650
840,KR,Medium,2049,85-89,1015114,1432998,2448112
840,KR,Medium,2049,90-94,419849,741652,1161501
840,KR,Medium,2049,95-99,81941,194116,276057
840,KR,Medium,2050,0-4,667128,632390,1299518
840,KR,Medium,2050,10岿 14老,726126,688638,1414764
840,KR,Medium,2050,100+,788144,747672,1535816
840,KR,Medium,2050,15-19,870804,826502,1697306
840,KR,Medium,2050,20-24,877277,834633,1711910
840,KR,Medium,2050,25-29,759017,745755,1504772
840,KR,Medium,2050,30-34,904062,893205,1797267
840,KR,Medium,2050,35-39,1164188,1142917,2307105
840,KR,Medium,2050,40-44,1167287,1136142,2303429
840,KR,Medium,2050,45-49,1339863,1274810,2614673
840,KR,Medium,2050,05岿 09老,1806505,1668987,3475492
840,KR,Medium,2050,50-54,1977431,1742479,3719910
840,KR,Medium,2050,55-59,1750949,1604460,3355409
840,KR,Medium,2050,60-64,1955994,1892419,3848413
840,KR,Medium,2050,65-69,1856476,1887732,3744208
840,KR,Medium,2050,70-74,1902429,2054686,3957115
840,KR,Medium,2050,75-79,3125805,4331588,7457393
840,KR,Medium,2050,80-84,1546647,1858336,3404983
840,KR,Medium,2050,85-89,1021225,1423541,2444766
840,KR,Medium,2050,90-94,453178,795078,1248256
840,KR,Medium,2050,95-99,94233,219615,313848
840,KR,Medium,2051,0-4,649296,615489,1264785
840,KR,Medium,2051,10岿 14老,716050,679081,1395131
840,KR,Medium,2051,100+,772022,732377,1504399
840,KR,Medium,2051,15-19,855731,812198,1667929
840,KR,Medium,2051,20-24,888147,844885,1733032
840,KR,Medium,2051,25-29,780501,766120,1546621
840,KR,Medium,2051,30-34,835192,826730,1661922
840,KR,Medium,2051,35-39,1137484,1119545,2257029
840,KR,Medium,2051,40-44,1185522,1156914,2342436
840,KR,Medium,2051,45-49,1245554,1194228,2439782
840,KR,Medium,2051,05岿 09老,1737099,1621932,3359031
840,KR,Medium,2051,50-54,2001234,1765466,3766700
840,KR,Medium,2051,55-59,1766018,1608298,3374316
840,KR,Medium,2051,60-64,1880099,1805696,3685795
840,KR,Medium,2051,65-69,1905203,1922361,3827564
840,KR,Medium,2051,70-74,1842945,1984144,3827089
840,KR,Medium,2051,75-79,3221428,4436903,7658331
840,KR,Medium,2051,80-84,1595090,1906093,3501183
840,KR,Medium,2051,85-89,1018538,1397132,2415670
840,KR,Medium,2051,90-94,492972,858538,1351510
840,KR,Medium,2051,95-99,104140,239819,343959
840,KR,Medium,2052,0-4,630175,597365,1227540
840,KR,Medium,2052,10岿 14老,705369,668951,1374320
840,KR,Medium,2052,100+,757586,718686,1476272
840,KR,Medium,2052,15-19,838818,796146,1634964
840,KR,Medium,2052,20-24,891746,848340,1740086
840,KR,Medium,2052,25-29,808469,792606,1601075
840,KR,Medium,2052,30-34,787386,781612,1568998
840,KR,Medium,2052,35-39,1092604,1078040,2170644
840,KR,Medium,2052,40-44,1191646,1163889,2355535
840,KR,Medium,2052,45-49,1204127,1163452,2367579
840,KR,Medium,2052,05岿 09老,1642070,1540556,3182626
840,KR,Medium,2052,50-54,1974340,1755927,3730267
840,KR,Medium,2052,55-59,1821952,1645492,3467444
840,KR,Medium,2052,60-64,1795334,1711349,3506683
840,KR,Medium,2052,65-69,1958435,1969792,3928227
840,KR,Medium,2052,70-74,1790529,1919891,3710420
840,KR,Medium,2052,75-79,3300384,4516106,7816490
840,KR,Medium,2052,80-84,1635604,1936606,3572210
840,KR,Medium,2052,85-89,1030928,1406662,2437590
840,KR,Medium,2052,90-94,508236,876485,1384721
840,KR,Medium,2052,95-99,113657,257674,371331
840,KR,Medium,2053,0-4,610601,578811,1189412
840,KR,Medium,2053,10岿 14老,693367,657568,1350935
840,KR,Medium,2053,100+,744912,706663,1451575
840,KR,Medium,2053,15-19,820929,779175,1600104
840,KR,Medium,2053,20-24,888005,844887,1732892
840,KR,Medium,2053,25-29,835778,818452,1654230
840,KR,Medium,2053,30-34,764590,760099,1524689
840,KR,Medium,2053,35-39,1033379,1021253,2054632
840,KR,Medium,2053,40-44,1179199,1154427,2333626
840,KR,Medium,2053,45-49,1196999,1163086,2360085
840,KR,Medium,2053,05岿 09老,1538826,1448830,2987656
840,KR,Medium,2053,50-54,1926625,1739124,3665749
840,KR,Medium,2053,55-59,1888897,1688985,3577882
840,KR,Medium,2053,60-64,1733793,1637818,3371611
840,KR,Medium,2053,65-69,1983068,1983682,3966750
840,KR,Medium,2053,70-74,1745120,1860661,3605781
840,KR,Medium,2053,75-79,3370328,4590647,7960975
840,KR,Medium,2053,80-84,1665920,1954697,3620617
840,KR,Medium,2053,85-89,1034592,1414863,2449455
840,KR,Medium,2053,90-94,532012,902086,1434098
840,KR,Medium,2053,95-99,124822,277558,402380
840,KR,Medium,2054,0-4,591600,560798,1152398
840,KR,Medium,2054,10岿 14老,679536,644454,1323990
840,KR,Medium,2054,100+,733738,696062,1429800
840,KR,Medium,2054,15-19,802926,762096,1565022
840,KR,Medium,2054,20-24,878859,836340,1715199
840,KR,Medium,2054,25-29,859688,841067,1700755
840,KR,Medium,2054,30-34,758370,754229,1512599
840,KR,Medium,2054,35-39,977108,967662,1944770
840,KR,Medium,2054,40-44,1170039,1147946,2317985
840,KR,Medium,2054,45-49,1176916,1148410,2325326
840,KR,Medium,2054,05岿 09老,1450670,1376290,2826960
840,KR,Medium,2054,50-54,1865569,1706843,3572412
840,KR,Medium,2054,55-59,1938265,1722890,3661155
840,KR,Medium,2054,60-64,1714315,1602589,3316904
840,KR,Medium,2054,65-69,1971545,1958289,3929834
840,KR,Medium,2054,70-74,1712929,1814955,3527884
840,KR,Medium,2054,75-79,3429153,4650954,8080107
840,KR,Medium,2054,80-84,1658799,1930412,3589211
840,KR,Medium,2054,85-89,1090612,1487687,2578299
840,KR,Medium,2054,90-94,529929,889604,1419533
840,KR,Medium,2054,95-99,135794,299069,434863
840,KR,Medium,2055,0-4,574238,544340,1118578
840,KR,Medium,2055,10岿 14老,663702,629440,1293142
840,KR,Medium,2055,100+,723511,686358,1409869
840,KR,Medium,2055,15-19,785592,745656,1531248
840,KR,Medium,2055,20-24,866469,824741,1691210
840,KR,Medium,2055,25-29,877495,857889,1735384
840,KR,Medium,2055,30-34,766238,761647,1527885
840,KR,Medium,2055,35-39,908937,902388,1811325
840,KR,Medium,2055,40-44,1168139,1149015,2317154
840,KR,Medium,2055,45-49,1172360,1146316,2318676
840,KR,Medium,2055,05岿 09老,1345289,1286929,2632218
840,KR,Medium,2055,50-54,1807778,1678870,3486648
840,KR,Medium,2055,55-59,1970602,1747160,3717762
840,KR,Medium,2055,60-64,1731327,1601079,3332406
840,KR,Medium,2055,65-69,1901254,1872527,3773781
840,KR,Medium,2055,70-74,1741548,1833333,3574881
840,KR,Medium,2055,75-79,3458806,4674929,8133735
840,KR,Medium,2055,80-84,1637812,1896038,3533850
840,KR,Medium,2055,85-89,1119854,1515038,2634892
840,KR,Medium,2055,90-94,536630,888952,1425582
840,KR,Medium,2055,95-99,148106,324185,472291
840,KR,Medium,2056,0-4,559475,530346,1089821
840,KR,Medium,2056,10岿 14老,646051,612702,1258753
840,KR,Medium,2056,100+,713488,676851,1390339
840,KR,Medium,2056,15-19,769548,730442,1499990
840,KR,Medium,2056,20-24,851468,810685,1662153
840,KR,Medium,2056,25-29,888470,868233,1756703
840,KR,Medium,2056,30-34,787821,782020,1569841
840,KR,Medium,2056,35-39,840030,836063,1676093
840,KR,Medium,2056,40-44,1141522,1125723,2267245
840,KR,Medium,2056,45-49,1190686,1167147,2357833
840,KR,Medium,2056,05岿 09老,1251182,1206254,2457436
840,KR,Medium,2056,50-54,1739004,1631966,3370970
840,KR,Medium,2056,55-59,1994940,1770329,3765269
840,KR,Medium,2056,60-64,1747244,1605246,3352490
840,KR,Medium,2056,65-69,1829087,1787360,3616447
840,KR,Medium,2056,70-74,1790545,1868629,3659174
840,KR,Medium,2056,75-79,3471377,4677997,8149374
840,KR,Medium,2056,80-84,1590336,1833268,3423604
840,KR,Medium,2056,85-89,1160527,1557958,2718485
840,KR,Medium,2056,90-94,540226,879671,1419897
840,KR,Medium,2056,95-99,162239,352117,514356
840,KR,Medium,2057,0-4,548025,519491,1067516
840,KR,Medium,2057,10岿 14老,627120,594752,1221872
840,KR,Medium,2057,100+,702863,666770,1369633
840,KR,Medium,2057,15-19,755182,716825,1472007
840,KR,Medium,2057,20-24,834646,794914,1629560
840,KR,Medium,2057,25-29,892198,871711,1763909
840,KR,Medium,2057,30-34,815913,808513,1624426
840,KR,Medium,2057,35-39,792183,791069,1583252
840,KR,Medium,2057,40-44,1096694,1084308,2181002
840,KR,Medium,2057,45-49,1196947,1174209,2371156
840,KR,Medium,2057,05岿 09老,1209817,1175404,2385221
840,KR,Medium,2057,50-54,1644593,1550724,3195317
840,KR,Medium,2057,55-59,1968945,1761057,3730002
840,KR,Medium,2057,60-64,1803465,1642631,3446096
840,KR,Medium,2057,65-69,1748375,1694738,3443113
840,KR,Medium,2057,70-74,1843213,1915960,3759173
840,KR,Medium,2057,75-79,3477806,4666266,8144072
840,KR,Medium,2057,80-84,1548916,1775856,3324772
840,KR,Medium,2057,85-89,1193098,1584481,2777579
840,KR,Medium,2057,90-94,549345,889054,1438399
840,KR,Medium,2057,95-99,166627,357486,524113
840,KR,Medium,2058,0-4,540248,512117,1052365
840,KR,Medium,2058,10岿 14老,607740,576377,1184117
840,KR,Medium,2058,100+,690923,655444,1346367
840,KR,Medium,2058,15-19,742570,704869,1447439
840,KR,Medium,2058,20-24,816861,778239,1595100
840,KR,Medium,2058,25-29,888577,868233,1756810
840,KR,Medium,2058,30-34,843353,834365,1677718
840,KR,Medium,2058,35-39,769369,769640,1539009
840,KR,Medium,2058,40-44,1037494,1027637,2065131
840,KR,Medium,2058,45-49,1184633,1164802,2349435
840,KR,Medium,2058,05岿 09老,1202800,1175066,2377866
840,KR,Medium,2058,50-54,1541887,1459069,3000956
840,KR,Medium,2058,55-59,1922140,1744485,3666625
840,KR,Medium,2058,60-64,1870583,1686289,3556872
840,KR,Medium,2058,65-69,1690126,1622637,3312763
840,KR,Medium,2058,70-74,1868196,1930280,3798476
840,KR,Medium,2058,75-79,3485430,4658676,8144106
840,KR,Medium,2058,80-84,1514387,1724050,3238437
840,KR,Medium,2058,85-89,1217723,1601437,2819160
840,KR,Medium,2058,90-94,556162,900850,1457012
840,KR,Medium,2058,95-99,175293,368190,543483
840,KR,Medium,2059,0-4,536108,508191,1044299
840,KR,Medium,2059,10岿 14老,588930,558541,1147471
840,KR,Medium,2059,100+,677163,642392,1319555
840,KR,Medium,2059,15-19,731450,694328,1425778
840,KR,Medium,2059,20-24,798974,761457,1560431
840,KR,Medium,2059,25-29,879530,859626,1739156
840,KR,Medium,2059,30-34,867378,856988,1724366
840,KR,Medium,2059,35-39,763163,763824,1526987
840,KR,Medium,2059,40-44,981223,974161,1955384
840,KR,Medium,2059,45-49,1175555,1158357,2333912
840,KR,Medium,2059,05岿 09老,1182920,1160468,2343388
840,KR,Medium,2059,50-54,1454156,1386558,2840714
840,KR,Medium,2059,55-59,1861986,1712431,3574417
840,KR,Medium,2059,60-64,1920344,1720370,3640714
840,KR,Medium,2059,65-69,1672735,1588335,3261070
840,KR,Medium,2059,70-74,1858509,1905921,3764430
840,KR,Medium,2059,75-79,3497966,4654045,8152011
840,KR,Medium,2059,80-84,1492115,1685275,3177390
840,KR,Medium,2059,85-89,1217442,1586059,2803501
840,KR,Medium,2059,90-94,590635,951996,1542631
840,KR,Medium,2059,95-99,173922,361405,535327
840,KR,Medium,2060,0-4,535191,507319,1042510
840,KR,Medium,2060,10岿 14老,571743,542243,1113986
840,KR,Medium,2060,100+,661410,627450,1288860
840,KR,Medium,2060,15-19,721272,684680,1405952
840,KR,Medium,2060,20-24,781760,745303,1527063
840,KR,Medium,2060,25-29,867230,847941,1715171
840,KR,Medium,2060,30-34,885272,873820,1759092
840,KR,Medium,2060,35-39,771061,771273,1542334
840,KR,Medium,2060,40-44,913057,908997,1822054
840,KR,Medium,2060,45-49,1173741,1159484,2333225
840,KR,Medium,2060,05岿 09老,1178481,1158413,2336894
840,KR,Medium,2060,50-54,1349283,1297264,2646547
840,KR,Medium,2060,55-59,1805010,1684647,3489657
840,KR,Medium,2060,60-64,1953223,1744826,3698049
840,KR,Medium,2060,65-69,1690759,1587316,3278075
840,KR,Medium,2060,70-74,1793970,1823075,3617045
840,KR,Medium,2060,75-79,3541825,4679561,8221386
840,KR,Medium,2060,80-84,1523168,1706035,3229203
840,KR,Medium,2060,85-89,1204544,1559365,2763909
840,KR,Medium,2060,90-94,610071,973340,1583411
840,KR,Medium,2060,95-99,177650,364397,542047
840,KR,Medium,2061,0-4,536778,508820,1045598
840,KR,Medium,2061,10岿 14老,557130,528389,1085519
840,KR,Medium,2061,100+,643849,610791,1254640
840,KR,Medium,2061,15-19,711297,675221,1386518
840,KR,Medium,2061,20-24,765835,730355,1496190
840,KR,Medium,2061,25-29,852314,833778,1686092
840,KR,Medium,2061,30-34,896306,884176,1780482
840,KR,Medium,2061,35-39,792687,791649,1584336
840,KR,Medium,2061,40-44,844126,842749,1686875
840,KR,Medium,2061,45-49,1147236,1136241,2283477
840,KR,Medium,2061,05岿 09老,1196926,1179313,2376239
840,KR,Medium,2061,50-54,1255568,1216614,2472182
840,KR,Medium,2061,55-59,1737084,1637963,3375047
840,KR,Medium,2061,60-64,1978090,1768169,3746259
840,KR,Medium,2061,65-69,1707752,1591969,3299721
840,KR,Medium,2061,70-74,1728251,1741119,3469370
840,KR,Medium,2061,75-79,3590558,4704591,8295149
840,KR,Medium,2061,80-84,1571053,1741800,3312853
840,KR,Medium,2061,85-89,1173394,1510468,2683862
840,KR,Medium,2061,90-94,636142,1004318,1640460
840,KR,Medium,2061,95-99,180858,364525,545383
840,KR,Medium,2062,0-4,539967,511838,1051805
840,KR,Medium,2062,10岿 14老,545799,517647,1063446
840,KR,Medium,2062,100+,625015,592927,1217942
840,KR,Medium,2062,15-19,700720,665189,1365909
840,KR,Medium,2062,20-24,751584,716976,1468560
840,KR,Medium,2062,25-29,835568,817884,1653452
840,KR,Medium,2062,30-34,900066,887663,1787729
840,KR,Medium,2062,35-39,820840,818122,1638962
840,KR,Medium,2062,40-44,796237,797794,1594031
840,KR,Medium,2062,45-49,1102464,1094816,2197280
840,KR,Medium,2062,05岿 09老,1203383,1186486,2389869
840,KR,Medium,2062,50-54,1214384,1185758,2400142
840,KR,Medium,2062,55-59,1643540,1556942,3200482
840,KR,Medium,2062,60-64,1953226,1759233,3712459
840,KR,Medium,2062,65-69,1764155,1629584,3393739
840,KR,Medium,2062,70-74,1654804,1652255,3307059
840,KR,Medium,2062,75-79,3638736,4730143,8368879
840,KR,Medium,2062,80-84,1621224,1788012,3409236
840,KR,Medium,2062,85-89,1147069,1465578,2612647
840,KR,Medium,2062,90-94,655780,1022093,1677873
840,KR,Medium,2062,95-99,184873,370118,554991
840,KR,Medium,2063,0-4,543799,515470,1059269
840,KR,Medium,2063,10岿 14老,538100,510349,1048449
840,KR,Medium,2063,100+,605735,574639,1180374
840,KR,Medium,2063,15-19,688834,653913,1342747
840,KR,Medium,2063,20-24,739077,705226,1444303
840,KR,Medium,2063,25-29,817850,801079,1618929
840,KR,Medium,2063,30-34,896450,884199,1780649
840,KR,Medium,2063,35-39,848347,843950,1692297
840,KR,Medium,2063,40-44,773401,776380,1549781
840,KR,Medium,2063,45-49,1043285,1038107,2081392
840,KR,Medium,2063,05岿 09老,1191265,1177161,2368426
840,KR,Medium,2063,50-54,1207552,1185474,2393026
840,KR,Medium,2063,55-59,1541623,1465464,3007087
840,KR,Medium,2063,60-64,1907689,1742989,3650678
840,KR,Medium,2063,65-69,1831137,1673363,3504500
840,KR,Medium,2063,70-74,1602451,1583323,3185774
840,KR,Medium,2063,75-79,3664174,4730858,8395032
840,KR,Medium,2063,80-84,1645520,1802562,3448082
840,KR,Medium,2063,85-89,1127169,1427472,2554641
840,KR,Medium,2063,90-94,670772,1034800,1705572
840,KR,Medium,2063,95-99,189095,378692,567787
840,KR,Medium,2064,0-4,547386,518869,1066255
840,KR,Medium,2064,10岿 14老,534008,506465,1040473
840,KR,Medium,2064,100+,587018,556888,1143906
840,KR,Medium,2064,15-19,675133,640917,1316050
840,KR,Medium,2064,20-24,728053,694866,1422919
840,KR,Medium,2064,25-29,800020,784166,1584186
840,KR,Medium,2064,30-34,887385,875604,1762989
840,KR,Medium,2064,35-39,872437,866554,1738991
840,KR,Medium,2064,40-44,767198,770565,1537763
840,KR,Medium,2064,45-49,986993,984566,1971559
840,KR,Medium,2064,05岿 09老,1182300,1170755,2353055
840,KR,Medium,2064,50-54,1187954,1170973,2358927
840,KR,Medium,2064,55-59,1454528,1393069,2847597
840,KR,Medium,2064,60-64,1848827,1711267,3560094
840,KR,Medium,2064,65-69,1881070,1707589,3588659
840,KR,Medium,2064,70-74,1588609,1551044,3139653
840,KR,Medium,2064,75-79,3663671,4699933,8363604
840,KR,Medium,2064,80-84,1638014,1780024,3418038
840,KR,Medium,2064,85-89,1117448,1401317,2518765
840,KR,Medium,2064,90-94,674019,1029370,1703389
840,KR,Medium,2064,95-99,202838,403304,606142
840,KR,Medium,2065,0-4,550001,521347,1071348
840,KR,Medium,2065,10岿 14老,533105,505607,1038712
840,KR,Medium,2065,100+,569917,540668,1110585
840,KR,Medium,2065,15-19,659448,626037,1285485
840,KR,Medium,2065,20-24,717959,685382,1403341
840,KR,Medium,2065,25-29,782846,767888,1550734
840,KR,Medium,2065,30-34,875053,863932,1738985
840,KR,Medium,2065,35-39,890388,883369,1773757
840,KR,Medium,2065,40-44,775120,778004,1553124
840,KR,Medium,2065,45-49,918807,919315,1838122
840,KR,Medium,2065,05岿 09老,1180596,1171915,2352511
840,KR,Medium,2065,50-54,1183683,1168972,2352655
840,KR,Medium,2065,55-59,1350369,1303934,2654303
840,KR,Medium,2065,60-64,1793058,1683772,3476830
840,KR,Medium,2065,65-69,1914414,1732236,3646650
840,KR,Medium,2065,70-74,1608046,1551026,3159072
840,KR,Medium,2065,75-79,3642719,4644360,8287079
840,KR,Medium,2065,80-84,1583153,1703612,3286765
840,KR,Medium,2065,85-89,1148276,1425080,2573356
840,KR,Medium,2065,90-94,668020,1013148,1681168
840,KR,Medium,2065,95-99,210744,414145,624889
840,KR,Medium,2066,0-4,551133,522422,1073555
840,KR,Medium,2066,10岿 14老,534682,507098,1041780
840,KR,Medium,2066,100+,555377,526880,1082257
840,KR,Medium,2066,15-19,641963,609449,1251412
840,KR,Medium,2066,20-24,708053,676080,1384133
840,KR,Medium,2066,25-29,766951,752823,1519774
840,KR,Medium,2066,30-34,860091,849782,1709873
840,KR,Medium,2066,35-39,901471,893714,1795185
840,KR,Medium,2066,40-44,796786,798365,1595151
840,KR,Medium,2066,45-49,849815,852933,1702748
840,KR,Medium,2066,05岿 09老,1154246,1148710,2302956
840,KR,Medium,2066,50-54,1202270,1189938,2392208
840,KR,Medium,2066,55-59,1257228,1223397,2480625
840,KR,Medium,2066,60-64,1726391,1637442,3363833
840,KR,Medium,2066,65-69,1939725,1755768,3695493
840,KR,Medium,2066,70-74,1626518,1556631,3183149
840,KR,Medium,2066,75-79,3626646,4591607,8218253
840,KR,Medium,2066,80-84,1528548,1628784,3157332
840,KR,Medium,2066,85-89,1190207,1459758,2649965
840,KR,Medium,2066,90-94,653034,983861,1636895
840,KR,Medium,2066,95-99,221200,429073,650273
840,KR,Medium,2067,0-4,550507,521830,1072337
840,KR,Medium,2067,10岿 14老,537844,510092,1047936
840,KR,Medium,2067,100+,544101,516190,1060291
840,KR,Medium,2067,15-19,623208,591663,1214871
840,KR,Medium,2067,20-24,697540,666213,1363753
840,KR,Medium,2067,25-29,752718,739341,1492059
840,KR,Medium,2067,30-34,843292,833901,1677193
840,KR,Medium,2067,35-39,905266,897201,1802467
840,KR,Medium,2067,40-44,824997,824833,1649830
840,KR,Medium,2067,45-49,801848,807842,1609690
840,KR,Medium,2067,05岿 09老,1109562,1107253,2216815
840,KR,Medium,2067,50-54,1208953,1197219,2406172
840,KR,Medium,2067,55-59,1216334,1192587,2408921
840,KR,Medium,2067,60-64,1634141,1556809,3190950
840,KR,Medium,2067,65-69,1916402,1747359,3663761
840,KR,Medium,2067,70-74,1682598,1594543,3277141
840,KR,Medium,2067,75-79,3604558,4535082,8139640
840,KR,Medium,2067,80-84,1467872,1548257,3016129
840,KR,Medium,2067,85-89,1232394,1501476,2733870
840,KR,Medium,2067,90-94,641320,956868,1598188
840,KR,Medium,2067,95-99,228429,436658,665087
